"","GEOID","NAME","B28010_001E","B28010_001M","B28010_002E","B28010_002M","B28010_003E","B28010_003M","B28010_004E","B28010_004M","B28010_005E","B28010_005M","B28010_006E","B28010_006M","B28010_007E","B28010_007M"
"1","01001","Autauga County, Alabama",21856,424,20149,474,15930,592,1111,379,19038,559,4219,547,1707,271
"2","01003","Baldwin County, Alabama",87190,1307,81670,1419,68725,1756,2705,446,78965,1435,12945,1103,5520,668
"3","01005","Barbour County, Alabama",9088,301,7495,278,4815,310,322,98,7173,292,2680,285,1593,220
"4","01007","Bibb County, Alabama",7083,289,5968,355,3991,369,368,139,5600,359,1977,362,1115,227
"5","01009","Blount County, Alabama",21300,411,18575,523,14377,661,627,160,17948,513,4198,460,2725,374
"6","01011","Bullock County, Alabama",3419,222,2764,280,1834,252,134,75,2630,290,930,260,655,185
"7","01013","Butler County, Alabama",6531,290,5487,299,4215,302,428,125,5059,318,1272,175,1044,147
"8","01015","Calhoun County, Alabama",44295,619,39986,791,29997,1050,1823,360,38163,799,9989,891,4309,540
"9","01017","Chambers County, Alabama",13123,445,11535,455,8224,509,547,153,10988,489,3311,446,1588,300
"10","01019","Cherokee County, Alabama",9692,442,8177,427,5573,424,461,164,7716,456,2604,389,1515,248
"11","01021","Chilton County, Alabama",16562,453,14494,495,10437,619,720,175,13774,461,4057,473,2068,323
"12","01023","Choctaw County, Alabama",5211,218,4142,251,2917,279,261,97,3881,244,1225,203,1069,183
"13","01025","Clarke County, Alabama",8250,333,6692,313,4796,350,553,166,6139,309,1896,263,1558,294
"14","01027","Clay County, Alabama",5399,251,4394,266,3173,272,158,64,4236,281,1221,210,1005,202
"15","01029","Cleburne County, Alabama",5598,193,4840,251,3333,240,182,82,4658,254,1507,217,758,182
"16","01031","Coffee County, Alabama",20478,414,18616,431,14380,515,820,172,17796,451,4236,372,1862,245
"17","01033","Colbert County, Alabama",22640,528,19015,697,13682,634,644,150,18371,710,5333,528,3625,478
"18","01035","Conecuh County, Alabama",4187,265,2994,254,1979,269,116,72,2878,273,1015,217,1193,235
"19","01037","Coosa County, Alabama",3824,206,3336,223,2394,235,193,96,3143,219,942,193,488,136
"20","01039","Covington County, Alabama",14296,347,11811,433,8440,412,630,143,11181,413,3371,334,2485,292
"21","01041","Crenshaw County, Alabama",4653,162,3730,199,2554,192,221,55,3509,191,1176,170,923,140
"22","01043","Cullman County, Alabama",32939,529,29145,688,21236,688,1186,259,27959,726,7909,749,3794,477
"23","01045","Dale County, Alabama",19470,374,17690,423,12789,453,733,164,16957,448,4901,419,1780,297
"24","01047","Dallas County, Alabama",14385,422,11235,486,7384,396,699,177,10536,493,3851,451,3150,388
"25","01049","DeKalb County, Alabama",25601,548,22240,619,15937,667,1140,242,21100,621,6303,549,3361,390
"26","01051","Elmore County, Alabama",31630,647,28903,676,23613,647,1015,230,27888,733,5290,479,2727,382
"27","01053","Escambia County, Alabama",12878,566,10078,546,6755,419,390,125,9688,534,3323,411,2800,334
"28","01055","Etowah County, Alabama",38289,702,33971,802,24904,823,1781,350,32190,771,9067,646,4318,445
"29","01057","Fayette County, Alabama",6204,256,5071,275,3639,306,206,114,4865,278,1432,262,1133,165
"30","01059","Franklin County, Alabama",10955,379,8205,479,5381,382,355,132,7850,457,2824,457,2750,365
"31","01061","Geneva County, Alabama",10303,322,8771,301,6358,368,459,144,8312,329,2413,320,1532,266
"32","01063","Greene County, Alabama",2849,191,2043,282,1154,238,85,57,1958,277,889,213,806,242
"33","01065","Hale County, Alabama",5133,251,3943,280,2287,239,149,85,3794,272,1656,271,1190,205
"34","01067","Henry County, Alabama",6404,277,5580,298,3627,313,200,74,5380,300,1953,243,824,177
"35","01069","Houston County, Alabama",41095,345,36239,460,27187,505,2064,198,34175,453,9052,438,4856,288
"36","01071","Jackson County, Alabama",20276,511,17337,541,12210,593,986,213,16351,525,5127,544,2939,377
"37","01073","Jefferson County, Alabama",264105,1463,241233,2019,193303,2064,7674,642,233559,2168,47930,1790,22872,1297
"38","01075","Lamar County, Alabama",5351,272,4222,262,3138,259,271,91,3951,268,1084,211,1129,198
"39","01077","Lauderdale County, Alabama",37928,514,33303,729,25610,953,1776,355,31527,742,7693,688,4625,465
"40","01079","Lawrence County, Alabama",12469,325,9907,466,7025,483,365,98,9542,465,2882,316,2562,344
"41","01081","Lee County, Alabama",63122,839,59180,1045,51383,989,1993,367,57187,1003,7797,968,3942,535
"42","01083","Limestone County, Alabama",37987,502,34846,524,29138,670,975,189,33871,555,5708,553,3141,390
"43","01085","Lowndes County, Alabama",3878,154,2951,183,1959,202,174,78,2777,190,992,188,927,139
"44","01087","Macon County, Alabama",7136,331,5841,348,3900,364,152,47,5689,348,1941,277,1295,177
"45","01089","Madison County, Alabama",156305,1115,147815,1346,130062,1540,5322,541,142493,1442,17753,885,8490,839
"46","01091","Marengo County, Alabama",7248,316,5939,382,3943,355,279,107,5660,383,1996,339,1309,240
"47","01093","Marion County, Alabama",11131,404,9577,470,6405,566,676,194,8901,464,3172,423,1554,263
"48","01095","Marshall County, Alabama",35439,490,31938,565,24026,614,1388,222,30550,600,7912,595,3501,384
"49","01097","Mobile County, Alabama",158045,1246,143293,1458,105743,1724,5470,506,137823,1522,37550,1594,14752,951
"50","01099","Monroe County, Alabama",7333,305,4873,362,3202,273,473,142,4400,327,1671,293,2460,314
"51","01101","Montgomery County, Alabama",89134,970,81491,1147,61466,1471,2803,419,78688,1204,20025,1131,7643,569
"52","01103","Morgan County, Alabama",47459,585,41943,771,33063,889,2101,394,39842,786,8880,767,5516,597
"53","01105","Perry County, Alabama",2847,229,1796,263,1034,213,86,82,1710,255,762,211,1051,226
"54","01107","Pickens County, Alabama",6993,306,5871,345,3505,308,248,76,5623,326,2366,316,1122,193
"55","01109","Pike County, Alabama",11508,492,9587,456,6804,471,656,171,8931,480,2783,399,1921,318
"56","01111","Randolph County, Alabama",8607,342,7464,346,5269,375,449,179,7015,391,2195,316,1143,190
"57","01113","Russell County, Alabama",23141,483,20432,704,14424,757,708,215,19724,694,6008,618,2709,451
"58","01115","St. Clair County, Alabama",33218,567,30622,665,25281,755,1237,308,29385,657,5341,567,2596,423
"59","01117","Shelby County, Alabama",82005,620,78609,725,69638,926,2114,345,76495,795,8971,795,3396,430
"60","01119","Sumter County, Alabama",4808,217,3766,270,2652,295,132,70,3634,265,1114,205,1042,173
"61","01121","Talladega County, Alabama",31778,584,27488,732,19209,742,1147,222,26341,762,8279,648,4290,481
"62","01123","Tallapoosa County, Alabama",16380,454,14497,541,11222,546,910,215,13587,531,3275,461,1883,326
"63","01125","Tuscaloosa County, Alabama",81790,975,75188,1029,59593,1230,2501,401,72687,1023,15595,1134,6602,578
"64","01127","Walker County, Alabama",24646,400,21598,515,15129,623,1035,231,20563,552,6469,567,3048,306
"65","01129","Washington County, Alabama",5261,333,4423,315,3156,309,175,68,4248,324,1267,254,838,187
"66","01131","Wilcox County, Alabama",3626,227,2920,213,1845,199,409,110,2511,190,1075,223,706,138
"67","01133","Winston County, Alabama",9219,316,7888,381,5523,427,406,133,7482,378,2365,352,1331,237
"68","02013","Aleutians East Borough, Alaska",914,120,808,105,592,88,20,12,788,103,216,42,106,34
"69","02016","Aleutians West Census Area, Alaska",1004,201,934,205,687,158,22,11,912,204,247,75,70,30
"70","02020","Anchorage Municipality, Alaska",106695,891,103708,951,90429,1307,2724,458,100984,986,13279,949,2987,399
"71","02050","Bethel Census Area, Alaska",4520,170,4100,169,2279,163,53,29,4047,163,1821,148,420,56
"72","02060","Bristol Bay Borough, Alaska",315,53,291,49,237,43,11,8,280,47,54,19,24,11
"73","02063","Chugach Census Area, Alaska",2592,152,2467,163,2188,174,62,58,2405,163,279,139,125,78
"74","02066","Copper River Census Area, Alaska",946,125,869,114,680,115,86,54,783,110,189,78,77,36
"75","02068","Denali Borough, Alaska",531,306,511,295,463,273,31,23,480,281,48,31,20,20
"76","02070","Dillingham Census Area, Alaska",1372,83,1289,83,760,78,13,10,1276,83,529,63,83,21
"77","02090","Fairbanks North Star Borough, Alaska",35298,809,34345,836,29541,908,1187,354,33158,864,4804,573,953,246
"78","02100","Haines Borough, Alaska",773,106,737,101,618,113,44,41,693,92,119,65,36,32
"79","02105","Hoonah-Angoon Census Area, Alaska",811,121,652,107,455,84,9,10,643,109,197,44,159,51
"80","02110","Juneau City and Borough, Alaska",12922,279,12410,302,10690,385,333,104,12077,311,1720,311,512,159
"81","02122","Kenai Peninsula Borough, Alaska",22768,382,21241,382,18079,438,923,182,20318,419,3162,293,1527,243
"82","02130","Ketchikan Gateway Borough, Alaska",5487,127,5144,135,4460,138,189,52,4955,133,684,99,343,65
"83","02150","Kodiak Island Borough, Alaska",4416,225,4145,233,3558,242,202,108,3943,234,587,151,271,104
"84","02158","Kusilvak Census Area, Alaska",1815,98,1520,97,649,118,19,13,1501,99,871,83,295,48
"85","02164","Lake and Peninsula Borough, Alaska",319,157,282,144,183,94,10,8,272,139,99,55,37,20
"86","02170","Matanuska-Susitna Borough, Alaska",38056,314,36469,341,31433,461,1271,149,35198,339,5036,373,1587,191
"87","02180","Nome Census Area, Alaska",2714,134,2549,132,1565,116,41,19,2508,135,984,74,165,29
"88","02185","North Slope Borough, Alaska",2103,152,1830,177,1151,203,33,23,1797,177,679,123,273,79
"89","02188","Northwest Arctic Borough, Alaska",1756,78,1580,84,1034,76,30,16,1550,82,546,62,176,32
"90","02195","Petersburg Borough, Alaska",1211,141,1141,125,954,121,47,33,1094,112,187,51,70,33
"91","02198","Prince of Wales-Hyder Census Area, Alaska",2310,93,1995,93,1421,103,117,41,1878,86,574,62,315,54
"92","02220","Sitka City and Borough, Alaska",3439,149,3236,162,2771,171,102,37,3134,156,465,97,203,56
"93","02230","Skagway Municipality, Alaska",390,62,378,61,322,55,18,7,360,61,56,21,12,7
"94","02240","Southeast Fairbanks Census Area, Alaska",2127,122,1926,127,1580,128,64,29,1862,125,346,82,201,52
"95","02275","Wrangell City and Borough, Alaska",842,74,724,71,565,72,73,31,651,70,159,54,118,37
"96","02282","Yakutat City and Borough, Alaska",216,50,198,51,141,47,6,6,192,51,57,34,18,13
"97","02290","Yukon-Koyukuk Census Area, Alaska",1899,81,1394,75,876,80,91,30,1303,67,518,51,505,44
"98","04001","Apache County, Arizona",19443,380,12081,331,8864,379,943,167,11138,334,3217,291,7362,334
"99","04003","Cochise County, Arizona",49239,748,45162,777,39277,792,2694,317,42468,811,5885,575,4077,444
"100","04005","Coconino County, Arizona",51037,843,47752,915,40287,967,1614,305,46138,984,7465,627,3285,350
"101","04007","Gila County, Arizona",22306,611,19371,693,14621,707,1222,206,18149,702,4750,509,2935,429
"102","04009","Graham County, Arizona",11577,287,10508,298,7969,425,551,156,9957,309,2539,331,1069,196
"103","04011","Greenlee County, Arizona",3265,184,3144,200,1944,214,79,40,3065,208,1200,249,121,75
"104","04012","La Paz County, Arizona",8678,364,7702,365,5818,440,523,144,7179,378,1884,258,976,210
"105","04013","Maricopa County, Arizona",1632151,3830,1562569,4188,1372779,5230,52897,1654,1509672,4334,189790,3293,69582,2175
"106","04015","Mohave County, Arizona",93179,1199,85262,1208,69264,1571,6178,660,79084,1156,15998,1074,7917,745
"107","04017","Navajo County, Arizona",36567,645,30285,724,22542,693,1414,240,28871,728,7743,579,6282,416
"108","04019","Pima County, Arizona",417483,1735,394983,2095,335675,2946,16563,932,378420,2243,59308,1982,22500,1161
"109","04021","Pinal County, Arizona",145554,1497,137156,1483,118870,1588,5383,680,131773,1554,18286,1058,8398,610
"110","04023","Santa Cruz County, Arizona",16428,332,14681,385,11092,506,664,178,14017,429,3589,452,1747,287
"111","04025","Yavapai County, Arizona",103934,1022,97276,1217,84750,1277,6962,575,90314,1416,12526,1035,6658,652
"112","04027","Yuma County, Arizona",72716,958,65269,1020,50633,1030,2726,352,62543,1061,14636,823,7447,669
"113","05001","Arkansas County, Arkansas",6595,250,5578,277,3789,286,225,91,5353,288,1789,285,1017,195
"114","05003","Ashley County, Arkansas",7239,286,5926,294,4191,295,369,126,5557,289,1735,240,1313,224
"115","05005","Baxter County, Arkansas",18835,377,17009,428,13881,550,1729,318,15280,486,3128,391,1826,296
"116","05007","Benton County, Arkansas",101109,706,96050,826,82109,958,2243,319,93807,865,13941,836,5059,575
"117","05009","Boone County, Arkansas",15190,371,13876,466,10790,451,832,184,13044,464,3086,365,1314,239
"118","05011","Bradley County, Arkansas",3706,169,3122,179,1800,193,59,32,3063,175,1322,177,584,135
"119","05013","Calhoun County, Arkansas",1481,246,1286,282,868,185,83,48,1203,278,418,150,195,79
"120","05015","Carroll County, Arkansas",11168,400,9918,456,7810,479,677,198,9241,448,2108,320,1250,290
"121","05017","Chicot County, Arkansas",4014,170,3304,198,2050,206,263,105,3041,207,1254,184,710,129
"122","05019","Clark County, Arkansas",8056,304,6899,354,5170,385,176,67,6723,368,1729,306,1157,215
"123","05021","Clay County, Arkansas",6152,189,5171,224,3657,260,338,86,4833,231,1514,227,981,142
"124","05023","Cleburne County, Arkansas",10664,344,9340,377,6919,388,562,140,8778,367,2421,292,1324,255
"125","05025","Cleveland County, Arkansas",2745,153,2267,185,1742,187,126,65,2141,198,525,133,478,133
"126","05027","Columbia County, Arkansas",7768,523,6228,567,4261,438,339,111,5889,575,1967,340,1540,234
"127","05029","Conway County, Arkansas",8460,262,7351,309,5023,380,368,148,6983,328,2328,256,1109,232
"128","05031","Craighead County, Arkansas",41865,645,38367,784,30430,1090,1382,280,36985,720,7937,826,3498,508
"129","05033","Crawford County, Arkansas",22748,391,20162,573,14947,644,889,203,19273,593,5215,607,2586,437
"130","05035","Crittenden County, Arkansas",18561,305,16120,378,10853,488,584,122,15536,414,5267,473,2441,294
"131","05037","Cross County, Arkansas",6390,205,5454,255,3617,314,296,97,5158,246,1837,287,936,167
"132","05039","Dallas County, Arkansas",2326,161,1730,160,1048,137,71,41,1659,159,682,145,596,129
"133","05041","Desha County, Arkansas",4721,174,3876,187,2324,224,120,46,3756,192,1552,192,845,146
"134","05043","Drew County, Arkansas",6970,289,6094,327,4582,383,243,103,5851,341,1512,297,876,206
"135","05045","Faulkner County, Arkansas",46445,656,43561,747,36679,960,1133,289,42428,736,6882,681,2884,376
"136","05047","Franklin County, Arkansas",6718,282,5682,345,3843,380,305,104,5377,353,1839,286,1036,237
"137","05049","Fulton County, Arkansas",4636,243,3940,257,3097,264,430,121,3510,268,843,184,696,161
"138","05051","Garland County, Arkansas",41919,685,38431,742,29280,912,1770,250,36661,745,9151,832,3488,431
"139","05053","Grant County, Arkansas",6850,241,6061,279,4635,355,170,78,5891,267,1426,279,789,214
"140","05055","Greene County, Arkansas",17583,348,15933,419,11619,448,678,211,15255,430,4314,468,1650,266
"141","05057","Hempstead County, Arkansas",7566,363,6363,327,3991,301,236,103,6127,338,2372,312,1203,212
"142","05059","Hot Spring County, Arkansas",12070,399,10227,453,7003,440,504,145,9723,439,3224,355,1843,312
"143","05061","Howard County, Arkansas",5253,208,4675,243,3061,262,192,76,4483,257,1614,272,578,137
"144","05063","Independence County, Arkansas",14349,398,12372,534,9017,553,454,143,11918,546,3355,368,1977,359
"145","05065","Izard County, Arkansas",4623,275,3999,280,3005,275,270,76,3729,289,994,193,624,151
"146","05067","Jackson County, Arkansas",5978,274,5084,299,3278,283,209,77,4875,309,1806,248,894,141
"147","05069","Jefferson County, Arkansas",24416,482,21277,578,13905,618,892,212,20385,594,7372,642,3139,364
"148","05071","Johnson County, Arkansas",9849,285,8124,331,5917,331,419,152,7705,352,2207,248,1725,264
"149","05073","Lafayette County, Arkansas",2500,169,2095,176,1301,136,95,49,2000,175,794,145,405,105
"150","05075","Lawrence County, Arkansas",6260,218,5433,245,3875,232,236,72,5197,252,1558,227,827,127
"151","05077","Lee County, Arkansas",2767,173,2216,198,1313,193,125,60,2091,199,903,170,551,146
"152","05079","Lincoln County, Arkansas",3391,230,2803,251,1901,242,115,52,2688,253,902,198,588,121
"153","05081","Little River County, Arkansas",4753,227,4155,221,2838,244,108,48,4047,222,1317,215,598,147
"154","05083","Logan County, Arkansas",8271,268,7393,280,5125,282,349,88,7044,289,2268,301,878,131
"155","05085","Lonoke County, Arkansas",27277,370,25176,510,20233,543,534,142,24642,510,4943,452,2101,326
"156","05087","Madison County, Arkansas",6056,247,5396,276,3945,310,346,119,5050,303,1451,234,660,143
"157","05089","Marion County, Arkansas",6950,316,6328,319,4897,322,636,175,5692,346,1431,259,622,158
"158","05091","Miller County, Arkansas",16240,424,14458,546,10093,579,673,170,13785,536,4365,423,1782,354
"159","05093","Mississippi County, Arkansas",15565,409,13407,485,9179,502,694,177,12713,484,4228,414,2158,342
"160","05095","Monroe County, Arkansas",2816,157,2183,162,1374,154,67,43,2116,154,809,153,633,117
"161","05097","Montgomery County, Arkansas",3669,239,3069,240,2235,243,217,75,2852,231,834,165,600,154
"162","05099","Nevada County, Arkansas",3070,233,2516,282,1548,275,132,63,2384,292,968,219,554,157
"163","05101","Newton County, Arkansas",2769,186,2327,193,1819,192,344,114,1983,196,508,138,442,101
"164","05103","Ouachita County, Arkansas",8686,415,7234,425,5001,412,363,124,6871,434,2233,337,1452,228
"165","05105","Perry County, Arkansas",3732,209,3090,200,2338,224,235,100,2855,202,752,157,642,141
"166","05107","Phillips County, Arkansas",6315,269,4956,348,3224,353,164,79,4792,341,1732,256,1359,224
"167","05109","Pike County, Arkansas",4042,170,3372,183,2495,169,207,68,3165,176,877,156,670,135
"168","05111","Poinsett County, Arkansas",8992,246,7712,304,4935,312,314,89,7398,312,2777,269,1280,204
"169","05113","Polk County, Arkansas",7736,255,6843,282,5019,329,566,161,6277,255,1824,234,893,176
"170","05115","Pope County, Arkansas",23304,553,21117,591,16608,672,855,224,20262,603,4509,492,2187,392
"171","05117","Prairie County, Arkansas",3385,136,2981,168,1838,166,92,53,2889,174,1143,187,404,108
"172","05119","Pulaski County, Arkansas",164697,1214,151647,1329,120824,1872,4816,524,146831,1440,30823,1746,13050,873
"173","05121","Randolph County, Arkansas",7234,270,5970,314,4562,322,484,138,5486,338,1408,247,1264,269
"174","05123","St. Francis County, Arkansas",8146,272,7070,301,4033,332,270,99,6800,315,3037,355,1076,210
"175","05125","Saline County, Arkansas",47468,502,44807,587,35831,879,1027,228,43780,583,8976,795,2661,376
"176","05127","Scott County, Arkansas",3938,176,3242,226,2272,269,206,74,3036,228,970,201,696,150
"177","05129","Searcy County, Arkansas",2964,174,2361,193,1712,206,168,55,2193,189,649,145,603,140
"178","05131","Sebastian County, Arkansas",51587,591,46531,771,34639,945,1668,322,44863,812,11892,798,5056,671
"179","05133","Sevier County, Arkansas",5498,245,4838,279,3193,265,203,96,4635,291,1645,237,660,178
"180","05135","Sharp County, Arkansas",6841,342,5795,364,4171,310,440,118,5355,356,1624,284,1046,184
"181","05137","Stone County, Arkansas",4678,314,3587,316,2641,266,229,83,3358,312,946,242,1091,253
"182","05139","Union County, Arkansas",14791,406,11897,485,9129,504,1487,309,10410,511,2768,373,2894,338
"183","05141","Van Buren County, Arkansas",6951,274,5971,303,4199,331,337,125,5634,303,1772,337,980,176
"184","05143","Washington County, Arkansas",91329,859,85810,1072,70116,1418,2661,461,83149,1194,15694,1212,5519,690
"185","05145","White County, Arkansas",28599,534,25894,614,18573,629,935,210,24959,662,7321,601,2705,373
"186","05147","Woodruff County, Arkansas",2634,109,1892,143,1372,133,58,32,1834,149,520,103,742,121
"187","05149","Yell County, Arkansas",7541,226,6082,286,4362,327,244,91,5838,305,1720,315,1459,238
"188","06001","Alameda County, California",581683,1880,557927,2133,508452,2719,15600,759,542327,2165,49475,1745,23756,1118
"189","06003","Alpine County, California",434,91,421,91,392,92,45,28,376,89,29,18,13,10
"190","06005","Amador County, California",15394,447,14061,530,12288,506,1164,240,12897,522,1773,330,1333,334
"191","06007","Butte County, California",85292,767,80856,861,70240,1179,4176,461,76680,882,10616,908,4436,460
"192","06009","Calaveras County, California",16809,529,15722,564,13713,568,916,258,14806,637,2009,334,1087,308
"193","06011","Colusa County, California",7303,146,6441,245,4704,276,211,76,6230,253,1737,278,862,197
"194","06013","Contra Costa County, California",405106,1075,391522,1495,354492,2281,10745,729,380777,1639,37030,1472,13584,1159
"195","06015","Del Norte County, California",9531,284,8907,316,7400,396,617,159,8290,360,1507,294,624,179
"196","06017","El Dorado County, California",74535,913,70805,1077,64326,1130,2682,405,68123,1070,6479,649,3730,531
"197","06019","Fresno County, California",314421,970,289298,1659,229249,2231,8378,739,280920,1730,60049,1987,25123,1113
"198","06021","Glenn County, California",9753,267,8791,324,6991,349,447,144,8344,364,1800,295,962,200
"199","06023","Humboldt County, California",53729,684,50161,736,42641,984,3120,393,47041,746,7520,760,3568,410
"200","06025","Imperial County, California",45541,790,41520,832,30595,1032,1067,275,40453,827,10925,864,4021,506
"201","06027","Inyo County, California",7832,277,7182,281,6394,309,684,199,6498,280,788,168,650,142
"202","06029","Kern County, California",274705,1373,252401,1702,197544,2261,7670,637,244731,1816,54857,2048,22304,1315
"203","06031","Kings County, California",43286,495,40367,555,30591,799,1157,274,39210,604,9776,716,2919,390
"204","06033","Lake County, California",26307,542,23901,565,19415,657,1547,325,22354,602,4486,570,2406,339
"205","06035","Lassen County, California",8910,386,8009,389,6277,423,444,111,7565,409,1732,279,901,172
"206","06037","Los Angeles County, California",3342811,5387,3163055,6116,2735982,9669,90252,2099,3072803,5991,427073,6069,179756,3267
"207","06039","Madera County, California",43578,647,40731,746,31973,913,1742,323,38989,773,8758,827,2847,368
"208","06041","Marin County, California",103751,697,100473,817,95001,1020,4769,616,95704,1069,5472,623,3278,435
"209","06043","Mariposa County, California",7588,335,6809,346,5568,382,704,189,6105,368,1241,282,779,217
"210","06045","Mendocino County, California",34183,558,30510,704,25239,808,2490,387,28020,778,5271,653,3673,518
"211","06047","Merced County, California",81618,674,75995,848,57351,1239,1921,317,74074,834,18644,1189,5623,559
"212","06049","Modoc County, California",3413,244,2951,227,2290,224,304,97,2647,219,661,171,462,139
"213","06051","Mono County, California",5361,405,5224,393,4486,393,172,104,5052,426,738,273,137,91
"214","06053","Monterey County, California",129977,846,124013,886,100684,1151,3730,432,120283,961,23329,1053,5964,492
"215","06055","Napa County, California",48745,544,46860,605,41851,667,2374,315,44486,661,5009,484,1885,288
"216","06057","Nevada County, California",40877,653,38734,665,35462,771,1785,297,36949,749,3272,462,2143,454
"217","06059","Orange County, California",1057592,2642,1023501,3112,932962,3850,26506,1192,996995,3177,90539,2443,34091,1396
"218","06061","Placer County, California",149714,709,144511,837,134739,1082,5227,529,139284,969,9772,757,5203,477
"219","06063","Plumas County, California",8231,291,7529,332,6306,365,518,154,7011,349,1223,232,702,171
"220","06065","Riverside County, California",740506,2031,706392,2457,614623,3022,25526,1060,680866,2543,91769,2295,34114,1507
"221","06067","Sacramento County, California",559036,1538,536296,1763,473404,2751,17105,1015,519191,1906,62892,2206,22740,1044
"222","06069","San Benito County, California",19144,201,18430,266,15740,404,532,150,17898,284,2690,321,714,167
"223","06071","San Bernardino County, California",651743,2010,622758,2399,518443,3613,17591,1034,605167,2460,104315,2658,28985,1413
"224","06073","San Diego County, California",1139899,3376,1099518,3736,993228,4719,30990,1159,1068528,3735,106290,2843,40381,1682
"225","06075","San Francisco County, California",361222,2202,343914,2289,312795,2262,8339,705,335575,2417,31119,1564,17308,1047
"226","06077","San Joaquin County, California",234662,982,222097,1202,180725,1925,6247,574,215850,1248,41372,1748,12565,776
"227","06079","San Luis Obispo County, California",106790,1211,102118,1295,93056,1317,4160,476,97958,1438,9062,704,4672,667
"228","06081","San Mateo County, California",264892,1199,255849,1410,237180,1726,6372,533,249477,1412,18669,1028,9043,799
"229","06083","Santa Barbara County, California",147446,845,140061,1081,123525,1289,6012,532,134049,1284,16536,944,7385,776
"230","06085","Santa Clara County, California",646847,2058,628217,2344,585900,2995,15117,847,613100,2461,42317,1714,18630,1082
"231","06087","Santa Cruz County, California",96476,987,91880,1101,83337,1169,3863,441,88017,1173,8543,797,4596,549
"232","06089","Shasta County, California",71314,640,66774,694,55989,991,4353,473,62421,830,10785,819,4540,499
"233","06091","Sierra County, California",1151,153,968,138,773,134,104,56,864,150,195,98,183,111
"234","06093","Siskiyou County, California",18598,345,16862,379,14016,416,1427,199,15435,429,2846,315,1736,212
"235","06095","Solano County, California",153632,844,147690,1043,130293,1337,5415,603,142275,1076,17397,970,5942,581
"236","06097","Sonoma County, California",188841,973,181284,1178,163665,1333,8571,742,172713,1275,17619,1107,7557,808
"237","06099","Stanislaus County, California",175067,752,163783,1074,130608,1478,5035,500,158748,1178,33175,1379,11284,919
"238","06101","Sutter County, California",32703,347,30090,545,24545,512,1289,253,28801,560,5545,533,2613,379
"239","06103","Tehama County, California",24551,399,21874,517,17163,765,1371,266,20503,547,4711,556,2677,423
"240","06105","Trinity County, California",5492,221,4775,296,4044,308,573,204,4202,368,731,215,717,166
"241","06107","Tulare County, California",139631,703,128774,1021,95642,1583,3876,440,124898,1057,33132,1417,10857,778
"242","06109","Tuolumne County, California",23103,533,21283,649,17639,764,1564,288,19719,674,3644,562,1820,359
"243","06111","Ventura County, California",274471,963,259368,1496,230388,1915,8734,657,250634,1506,28980,1338,15103,1160
"244","06113","Yolo County, California",75471,570,71601,788,63927,947,2292,323,69309,867,7674,798,3870,586
"245","06115","Yuba County, California",26888,492,24934,550,20593,631,1094,290,23840,554,4341,435,1954,370
"246","08001","Adams County, Colorado",176880,678,168835,868,144475,1379,5476,652,163359,1097,24360,1374,8045,691
"247","08003","Alamosa County, Colorado",6327,181,5682,241,4577,339,405,129,5277,267,1105,234,645,160
"248","08005","Arapahoe County, Colorado",247251,950,239425,1054,216701,1483,7753,588,231672,1155,22724,1285,7826,589
"249","08007","Archuleta County, Colorado",5770,384,5406,411,4821,363,313,133,5093,416,585,172,364,114
"250","08009","Baca County, Colorado",1594,77,1390,88,1106,90,87,29,1303,91,284,59,204,40
"251","08011","Bent County, Colorado",1805,230,1566,200,1226,198,112,49,1454,193,340,112,239,78
"252","08013","Boulder County, Colorado",131701,697,127876,897,120445,1004,4199,439,123677,951,7431,539,3825,544
"253","08014","Broomfield County, Colorado",29487,276,28898,292,27445,358,793,180,28105,339,1453,258,589,160
"254","08015","Chaffee County, Colorado",8539,380,7584,456,6896,418,583,214,7001,471,688,227,955,310
"255","08017","Cheyenne County, Colorado",695,64,648,67,542,68,49,24,599,65,106,35,47,20
"256","08019","Clear Creek County, Colorado",4427,250,4198,252,3809,253,167,75,4031,266,389,145,229,86
"257","08021","Conejos County, Colorado",3097,146,2632,164,2045,151,126,36,2506,161,587,92,465,80
"258","08023","Costilla County, Colorado",1446,118,1281,125,908,114,44,22,1237,124,373,96,165,57
"259","08025","Crowley County, Colorado",1340,191,1151,169,951,158,98,40,1053,171,200,54,189,66
"260","08027","Custer County, Colorado",2124,227,2013,202,1679,196,190,95,1823,195,334,144,111,86
"261","08029","Delta County, Colorado",12143,351,10748,408,9102,443,1339,266,9409,408,1646,255,1395,256
"262","08031","Denver County, Colorado",313926,1487,300552,1635,264947,2145,8293,660,292259,1685,35605,1518,13374,889
"263","08033","Dolores County, Colorado",1144,122,1030,113,916,108,150,62,880,111,114,73,114,61
"264","08035","Douglas County, Colorado",127921,685,126047,707,121270,875,2402,335,123645,762,4777,573,1874,324
"265","08037","Eagle County, Colorado",19511,553,19198,583,15641,608,390,188,18808,597,3557,537,313,146
"266","08039","Elbert County, Colorado",9261,107,8961,134,8154,225,318,103,8643,147,807,194,300,81
"267","08041","El Paso County, Colorado",270178,1020,259907,1322,236947,1649,8443,672,251464,1366,22960,1242,10271,743
"268","08043","Fremont County, Colorado",17510,593,15900,604,13542,605,1322,238,14578,597,2358,353,1610,330
"269","08045","Garfield County, Colorado",21707,408,20589,437,16224,611,874,218,19715,463,4365,537,1118,268
"270","08047","Gilpin County, Colorado",2791,263,2700,285,2527,273,235,115,2465,294,173,90,91,96
"271","08049","Grand County, Colorado",5841,431,5431,444,4934,399,375,142,5056,452,497,169,410,132
"272","08051","Gunnison County, Colorado",7100,318,6819,343,5936,376,380,134,6439,325,883,229,281,131
"273","08053","Hinsdale County, Colorado",442,69,431,69,414,68,24,22,407,67,17,11,11,10
"274","08055","Huerfano County, Colorado",2744,213,2361,214,1974,204,167,60,2194,218,387,113,383,109
"275","08057","Jackson County, Colorado",632,90,546,70,488,72,99,51,447,69,58,34,86,64
"276","08059","Jefferson County, Colorado",236499,784,227608,1041,210587,1409,9050,655,218558,1310,17021,1107,8891,712
"277","08061","Kiowa County, Colorado",584,75,547,72,473,73,37,20,510,75,74,29,37,21
"278","08063","Kit Carson County, Colorado",2964,122,2697,129,2171,146,134,60,2563,135,526,123,267,80
"279","08065","Lake County, Colorado",2795,299,2476,305,1997,236,80,85,2396,313,479,227,319,147
"280","08067","La Plata County, Colorado",22266,457,20935,467,18557,498,681,155,20254,467,2378,314,1331,213
"281","08069","Larimer County, Colorado",145175,799,140971,1010,131300,1279,4920,420,136051,972,9671,916,4204,538
"282","08071","Las Animas County, Colorado",6410,256,5627,254,4345,269,283,72,5344,257,1282,180,783,150
"283","08073","Lincoln County, Colorado",1812,184,1584,181,1300,176,179,67,1405,177,284,63,228,60
"284","08075","Logan County, Colorado",7928,198,7250,255,5950,311,478,127,6772,282,1300,321,678,157
"285","08077","Mesa County, Colorado",61977,626,58105,821,50356,1009,3378,471,54727,883,7749,646,3872,598
"286","08079","Mineral County, Colorado",386,63,378,62,286,57,15,12,363,62,92,49,8,8
"287","08081","Moffat County, Colorado",5121,181,4786,206,3694,272,245,104,4541,217,1092,226,335,119
"288","08083","Montezuma County, Colorado",10461,305,9372,383,7911,394,1043,271,8329,513,1461,287,1089,226
"289","08085","Montrose County, Colorado",16840,324,14834,404,13236,425,1376,204,13458,428,1598,239,2006,328
"290","08087","Morgan County, Colorado",10601,211,9705,295,7222,375,431,119,9274,302,2483,314,896,198
"291","08089","Otero County, Colorado",7618,244,6565,302,4994,332,476,139,6089,314,1571,300,1053,210
"292","08091","Ouray County, Colorado",2204,157,2112,164,2022,151,117,48,1995,161,90,70,92,50
"293","08093","Park County, Colorado",7169,397,6925,385,6222,371,498,183,6427,376,703,239,244,122
"294","08095","Phillips County, Colorado",1715,164,1538,150,1262,161,107,66,1431,143,276,87,177,89
"295","08097","Pitkin County, Colorado",7202,408,7165,410,6699,414,80,59,7085,408,466,181,37,34
"296","08099","Prowers County, Colorado",4421,218,3854,263,2882,258,162,65,3692,256,972,214,567,128
"297","08101","Pueblo County, Colorado",66442,534,60169,680,47641,832,3356,384,56813,705,12528,749,6273,528
"298","08103","Rio Blanco County, Colorado",2488,143,2295,155,2006,155,205,81,2090,174,289,93,193,67
"299","08105","Rio Grande County, Colorado",4616,241,3958,222,3316,209,253,107,3705,237,642,157,658,154
"300","08107","Routt County, Colorado",10094,445,9690,433,8854,417,395,115,9295,466,836,186,404,180
"301","08109","Saguache County, Colorado",2877,147,2666,160,1935,176,182,69,2484,168,731,153,211,84
"302","08111","San Juan County, Colorado",326,50,298,51,288,51,24,16,274,49,10,11,28,23
"303","08113","San Miguel County, Colorado",3594,184,3498,186,3008,174,109,47,3389,194,490,117,96,47
"304","08115","Sedgwick County, Colorado",1020,94,899,85,670,81,61,18,838,84,229,63,121,33
"305","08117","Summit County, Colorado",11329,815,11050,801,10183,771,208,124,10842,805,867,281,279,162
"306","08119","Teller County, Colorado",10557,385,10053,431,9087,440,516,137,9537,443,966,275,504,158
"307","08121","Washington County, Colorado",2001,91,1790,96,1519,93,107,34,1683,89,271,60,211,53
"308","08123","Weld County, Colorado",111222,620,106451,741,92805,1007,3691,483,102760,927,13646,884,4771,450
"309","08125","Yuma County, Colorado",3884,144,3489,165,2867,215,169,80,3320,178,622,170,395,113
"310","09001","Fairfield County, Connecticut",349443,1385,330471,1769,296878,1982,13330,644,317141,1858,33593,1412,18972,1226
"311","09003","Hartford County, Connecticut",356529,1672,331319,1907,283753,2350,14637,940,316682,1996,47566,1635,25210,1134
"312","09005","Litchfield County, Connecticut",74857,860,69937,960,62488,1017,4375,587,65562,1112,7449,686,4920,501
"313","09007","Middlesex County, Connecticut",68200,695,63915,740,57067,951,3591,413,60324,850,6848,554,4285,458
"314","09009","New Haven County, Connecticut",336400,1482,309027,1843,263251,2287,13996,809,295031,1853,45776,1562,27373,1363
"315","09011","New London County, Connecticut",109481,850,101774,1101,89161,1280,5415,558,96359,1218,12613,866,7707,660
"316","09013","Tolland County, Connecticut",56989,676,54576,733,49408,889,2616,313,51960,831,5168,624,2413,309
"317","09015","Windham County, Connecticut",45425,528,41745,645,34944,752,2328,260,39417,701,6801,515,3680,405
"318","10001","Kent County, Delaware",66720,606,61610,756,51823,957,2959,414,58651,800,9787,807,5110,569
"319","10003","New Castle County, Delaware",218002,882,208306,1051,174284,1539,7568,741,200738,1221,34022,1515,9696,765
"320","10005","Sussex County, Delaware",96375,1090,89271,1214,76358,1329,4350,456,84921,1236,12913,916,7104,728
"321","11001","District of Columbia, District of Columbia",310104,1722,292737,2024,256104,2297,6787,601,285950,2030,36633,1781,17367,1361
"322","12001","Alachua County, Florida",105003,1128,100489,1254,87320,1448,3141,485,97348,1342,13169,967,4514,649
"323","12003","Baker County, Florida",8532,350,7790,391,6394,419,246,102,7544,396,1396,283,742,287
"324","12005","Bay County, Florida",72881,940,69123,1033,57591,1170,2712,331,66411,1088,11532,902,3758,518
"325","12007","Bradford County, Florida",8967,495,7658,534,5705,449,487,164,7171,524,1953,359,1309,330
"326","12009","Brevard County, Florida",242657,1780,229480,2030,204186,2076,12483,758,216997,2169,25294,1496,13177,1053
"327","12011","Broward County, Florida",732464,2763,697108,3265,608659,4144,20434,1358,676674,3416,88449,2744,35356,1706
"328","12013","Calhoun County, Florida",4495,268,3681,276,2879,264,183,96,3498,291,802,210,814,174
"329","12015","Charlotte County, Florida",82755,1252,76524,1172,66417,1284,4302,440,72222,1291,10107,868,6231,762
"330","12017","Citrus County, Florida",65843,1174,60853,1222,52258,1282,5227,515,55626,1272,8595,740,4990,605
"331","12019","Clay County, Florida",77434,817,74839,1049,66188,1198,2452,485,72387,1090,8651,810,2595,639
"332","12021","Collier County, Florida",153711,2198,146141,2335,126315,2273,6314,616,139827,2329,19826,1171,7570,818
"333","12023","Columbia County, Florida",25728,462,24040,528,18893,705,1266,261,22774,638,5147,610,1688,333
"334","12027","DeSoto County, Florida",12207,572,9966,631,7283,579,580,147,9386,639,2683,405,2241,383
"335","12029","Dixie County, Florida",6071,449,5116,399,3777,347,420,162,4696,427,1339,297,955,343
"336","12031","Duval County, Florida",387008,2233,362663,2410,303477,3067,12925,857,349738,2481,59186,2425,24345,1241
"337","12033","Escambia County, Florida",124494,1132,116477,1304,97401,1684,5752,607,110725,1296,19076,1328,8017,761
"338","12035","Flagler County, Florida",45491,692,42354,697,36142,948,2487,344,39867,727,6212,654,3137,477
"339","12037","Franklin County, Florida",4559,250,4112,291,3088,287,304,100,3808,292,1024,252,447,124
"340","12039","Gadsden County, Florida",15769,392,12811,432,9554,498,979,257,11832,507,3257,427,2958,370
"341","12041","Gilchrist County, Florida",6659,215,5892,263,4707,275,217,77,5675,271,1185,224,767,211
"342","12043","Glades County, Florida",4572,345,3980,351,2830,299,171,73,3809,348,1150,260,592,181
"343","12045","Gulf County, Florida",5519,559,5009,567,4205,472,336,114,4673,562,804,239,510,129
"344","12047","Hamilton County, Florida",4208,347,3497,377,2393,290,365,121,3132,363,1104,272,711,146
"345","12049","Hardee County, Florida",8032,267,6653,350,4873,414,538,203,6115,387,1780,306,1379,313
"346","12051","Hendry County, Florida",12821,476,11135,548,7431,509,589,246,10546,582,3704,539,1686,349
"347","12053","Hernando County, Florida",78041,787,73340,770,63668,1118,4728,504,68612,878,9672,920,4701,542
"348","12055","Highlands County, Florida",43977,787,39057,931,31009,1016,3122,434,35935,1031,8048,711,4920,664
"349","12057","Hillsborough County, Florida",547578,1835,525041,2380,453861,3229,15251,873,509790,2557,71180,2094,22537,1339
"350","12059","Holmes County, Florida",6995,322,6234,320,4465,343,501,165,5733,338,1769,286,761,176
"351","12061","Indian River County, Florida",63377,1057,58147,1124,51476,1236,3500,418,54647,1139,6671,663,5230,584
"352","12063","Jackson County, Florida",16859,460,14576,499,10587,481,865,234,13711,531,3989,409,2283,279
"353","12065","Jefferson County, Florida",5394,297,4719,276,3676,268,226,98,4493,279,1043,203,675,156
"354","12067","Lafayette County, Florida",2486,253,2190,274,1487,254,108,68,2082,260,703,240,296,144
"355","12069","Lake County, Florida",149455,1471,140662,1630,116285,2049,6830,833,133832,1759,24377,1679,8793,909
"356","12071","Lee County, Florida",298343,2343,284230,2519,243725,2604,12553,928,271677,2324,40505,1887,14113,971
"357","12073","Leon County, Florida",117677,1161,112844,1186,99326,1396,3376,422,109468,1254,13518,1024,4833,477
"358","12075","Levy County, Florida",17248,396,15227,486,11573,607,1029,231,14198,481,3654,496,2021,426
"359","12077","Liberty County, Florida",2279,265,1938,246,1402,178,155,72,1783,237,536,204,341,86
"360","12079","Madison County, Florida",6441,272,4805,290,3763,288,366,105,4439,311,1042,213,1636,270
"361","12081","Manatee County, Florida",156254,1915,148596,2005,129564,1960,7702,836,140894,2123,19032,1286,7658,751
"362","12083","Marion County, Florida",150880,1433,137759,1933,116873,2025,9509,923,128250,2078,20886,1330,13121,1165
"363","12085","Martin County, Florida",66108,900,62313,1063,53916,1172,3323,406,58990,1100,8397,708,3795,545
"364","12086","Miami-Dade County, Florida",936351,2672,881539,2972,729949,4312,20445,1270,861094,2773,151590,3328,54812,2228
"365","12087","Monroe County, Florida",33643,702,31900,768,27762,701,1205,257,30695,841,4138,444,1743,337
"366","12089","Nassau County, Florida",34691,529,33736,551,29715,759,1420,290,32316,550,4021,552,955,213
"367","12091","Okaloosa County, Florida",81785,792,77505,982,67380,968,3015,373,74490,986,10125,814,4280,553
"368","12093","Okeechobee County, Florida",14794,513,13117,513,10101,487,616,163,12501,510,3016,383,1677,338
"369","12095","Orange County, Florida",475292,2844,459191,3007,400110,3379,9856,823,449335,3099,59081,2505,16101,1075
"370","12097","Osceola County, Florida",110156,1530,104752,1628,90482,2052,2707,526,102045,1602,14270,1320,5404,916
"371","12099","Palm Beach County, Florida",581119,2763,550396,2888,470493,3321,19496,1003,530900,3033,79903,2489,30723,1460
"372","12101","Pasco County, Florida",217318,1521,203062,1911,178386,1936,10131,580,192931,1918,24676,1186,14256,1141
"373","12103","Pinellas County, Florida",415730,2395,388550,2420,339013,2722,20282,955,368268,2439,49537,1713,27180,1301
"374","12105","Polk County, Florida",253178,1861,234229,1927,188472,2421,10949,765,223280,2072,45757,1767,18949,995
"375","12107","Putnam County, Florida",29174,552,25217,784,18516,799,1440,252,23777,745,6701,558,3957,620
"376","12109","St. Johns County, Florida",95640,1060,91692,1159,83483,1520,3581,544,88111,1142,8209,931,3948,538
"377","12111","St. Lucie County, Florida",122186,1457,115704,1649,100432,1802,5481,697,110223,1779,15272,1251,6482,969
"378","12113","Santa Rosa County, Florida",67534,709,64609,933,57540,1028,2658,464,61951,1000,7069,604,2925,550
"379","12115","Sarasota County, Florida",193923,1848,182458,2044,161197,2070,12306,1030,170152,2211,21261,1019,11465,878
"380","12117","Seminole County, Florida",180891,1085,174983,1117,156060,1485,4639,477,170344,1152,18923,1136,5908,594
"381","12119","Sumter County, Florida",61441,1068,57054,1453,49950,1400,4167,674,52887,1387,7104,1026,4387,1058
"382","12121","Suwannee County, Florida",15098,515,12754,616,10177,575,736,188,12018,644,2577,477,2344,564
"383","12123","Taylor County, Florida",7270,445,6184,462,4925,438,545,261,5639,396,1259,279,1086,300
"384","12125","Union County, Florida",4064,248,3589,271,2381,257,134,68,3455,269,1208,238,475,128
"385","12127","Volusia County, Florida",228569,1463,215082,1660,179977,1869,11551,965,203531,1889,35105,1658,13487,1134
"386","12129","Wakulla County, Florida",11266,441,10843,445,8833,528,399,144,10444,490,2010,434,423,172
"387","12131","Walton County, Florida",30182,1049,28588,1012,24549,1074,1114,302,27474,1017,4039,597,1594,371
"388","12133","Washington County, Florida",8853,348,7982,398,6035,360,454,130,7528,375,1947,285,871,144
"389","13001","Appling County, Georgia",6637,302,5907,317,3416,284,202,94,5705,333,2491,336,730,163
"390","13003","Atkinson County, Georgia",2968,122,2499,150,1520,188,169,63,2330,155,979,181,469,103
"391","13005","Bacon County, Georgia",3874,212,3324,210,2133,239,97,59,3227,213,1191,177,550,143
"392","13007","Baker County, Georgia",1201,137,837,124,471,102,74,46,763,119,366,99,364,131
"393","13009","Baldwin County, Georgia",15948,594,14397,671,11772,586,740,192,13657,712,2625,490,1551,306
"394","13011","Banks County, Georgia",6483,186,5659,216,4513,266,191,63,5468,215,1146,203,824,159
"395","13013","Barrow County, Georgia",28087,306,26485,396,22812,572,1087,203,25398,415,3673,467,1602,265
"396","13015","Bartow County, Georgia",38029,626,35470,734,29734,949,1162,310,34308,771,5736,679,2559,449
"397","13017","Ben Hill County, Georgia",6828,318,5958,350,3894,376,156,83,5802,365,2064,389,870,198
"398","13019","Berrien County, Georgia",6634,252,5543,311,4223,323,285,95,5258,299,1320,230,1091,210
"399","13021","Bibb County, Georgia",58752,791,52721,993,41163,965,1983,308,50738,996,11558,835,6031,714
"400","13023","Bleckley County, Georgia",4232,198,3705,229,2922,244,229,103,3476,234,783,191,527,163
"401","13025","Brantley County, Georgia",6625,290,6123,355,4182,367,140,94,5983,350,1941,322,502,201
"402","13027","Brooks County, Georgia",6004,274,4974,328,3467,275,298,137,4676,334,1507,298,1030,220
"403","13029","Bryan County, Georgia",14796,354,13962,422,12031,485,254,100,13708,433,1931,421,834,224
"404","13031","Bulloch County, Georgia",28917,999,27169,1029,22581,1020,1007,288,26162,1045,4588,558,1748,320
"405","13033","Burke County, Georgia",8742,433,7832,494,5629,479,522,142,7310,502,2203,403,910,216
"406","13035","Butts County, Georgia",8440,424,7512,437,6102,469,384,170,7128,443,1410,424,928,270
"407","13037","Calhoun County, Georgia",1457,140,1185,136,834,114,33,25,1152,131,351,82,272,80
"408","13039","Camden County, Georgia",20032,465,19121,490,15856,642,610,160,18511,523,3265,442,911,255
"409","13043","Candler County, Georgia",4034,180,3417,229,2314,230,199,99,3218,234,1103,242,617,155
"410","13045","Carroll County, Georgia",42635,645,39033,787,31842,903,1143,361,37890,803,7191,621,3602,455
"411","13047","Catoosa County, Georgia",25450,455,23442,549,18812,642,1005,240,22437,577,4630,644,2008,344
"412","13049","Charlton County, Georgia",3960,216,3412,294,2294,209,291,133,3121,312,1118,264,548,174
"413","13051","Chatham County, Georgia",115403,1073,109396,1259,91166,1646,2987,474,106409,1276,18230,1293,6007,568
"414","13053","Chattahoochee County, Georgia",2404,370,2172,366,1766,317,37,28,2135,361,406,124,232,83
"415","13055","Chattooga County, Georgia",9189,264,7647,298,4961,360,426,121,7221,322,2686,312,1542,211
"416","13057","Cherokee County, Georgia",94208,761,91333,947,83850,1162,2413,553,88920,1006,7483,884,2875,420
"417","13059","Clarke County, Georgia",52352,669,49489,771,43627,869,1592,319,47897,833,5862,677,2863,396
"418","13061","Clay County, Georgia",1286,157,1150,155,672,139,61,53,1089,155,478,129,136,49
"419","13063","Clayton County, Georgia",103399,800,97473,1027,79208,1604,3674,549,93799,1164,18265,1269,5926,744
"420","13065","Clinch County, Georgia",2361,287,1892,270,1333,216,106,78,1786,270,559,188,469,164
"421","13067","Cobb County, Georgia",287426,1270,281302,1417,256816,1680,5644,458,275658,1486,24486,1268,6124,763
"422","13069","Coffee County, Georgia",14934,408,13138,506,9097,536,427,105,12711,506,4041,521,1796,311
"423","13071","Colquitt County, Georgia",16219,459,14263,507,9355,454,1046,264,13217,504,4908,501,1956,395
"424","13073","Columbia County, Georgia",47597,856,45234,980,40208,1085,1412,327,43822,1032,5026,638,2363,563
"425","13075","Cook County, Georgia",6056,229,5174,285,3893,300,237,95,4937,277,1281,235,882,184
"426","13077","Coweta County, Georgia",53405,468,50931,653,44255,850,1597,304,49334,722,6676,688,2474,456
"427","13079","Crawford County, Georgia",4283,206,3802,232,2888,287,155,91,3647,216,914,229,481,149
"428","13081","Crisp County, Georgia",7651,324,6495,406,4433,433,215,95,6280,390,2062,318,1156,274
"429","13083","Dade County, Georgia",6142,279,5394,302,4123,335,320,137,5074,327,1271,260,748,168
"430","13085","Dawson County, Georgia",9776,350,9307,344,8416,379,268,112,9039,358,891,227,469,155
"431","13087","Decatur County, Georgia",10242,386,8088,394,5477,403,247,112,7841,403,2611,381,2154,377
"432","13089","DeKalb County, Georgia",286068,1917,270991,2175,233109,2785,6991,760,264000,2271,37882,1940,15077,1380
"433","13091","Dodge County, Georgia",6569,392,5487,344,4290,357,504,158,4983,381,1197,226,1082,224
"434","13093","Dooly County, Georgia",3888,267,3086,257,2226,221,212,91,2874,276,860,172,802,171
"435","13095","Dougherty County, Georgia",34338,670,30594,801,22573,830,1297,231,29297,808,8021,699,3744,478
"436","13097","Douglas County, Georgia",50188,622,47787,666,41309,1046,898,228,46889,641,6478,826,2401,440
"437","13099","Early County, Georgia",4034,220,2921,237,1850,242,121,55,2800,234,1071,199,1113,194
"438","13101","Echols County, Georgia",1327,156,897,153,710,137,72,60,825,137,187,78,430,135
"439","13103","Effingham County, Georgia",22313,283,21160,419,17592,620,556,173,20604,429,3568,519,1153,312
"440","13105","Elbert County, Georgia",7773,230,6121,344,4564,362,399,135,5722,322,1557,299,1652,258
"441","13107","Emanuel County, Georgia",8245,302,7171,327,4889,388,248,87,6923,322,2282,296,1074,209
"442","13109","Evans County, Georgia",3886,168,3393,183,2022,173,63,34,3330,181,1371,193,493,123
"443","13111","Fannin County, Georgia",11188,476,9984,512,8511,535,569,158,9415,547,1473,284,1204,295
"444","13113","Fayette County, Georgia",42351,404,41025,480,38170,610,1543,306,39482,560,2855,449,1326,268
"445","13115","Floyd County, Georgia",35859,541,32456,683,25211,866,1964,526,30492,753,7245,590,3403,404
"446","13117","Forsyth County, Georgia",82293,434,80714,499,76349,657,1487,228,79227,550,4365,420,1579,232
"447","13119","Franklin County, Georgia",8346,255,7321,305,5311,347,401,128,6920,305,2010,313,1025,213
"448","13121","Fulton County, Georgia",441958,2293,420862,2613,376572,3425,10337,972,410525,2698,44290,2370,21096,1418
"449","13123","Gilmer County, Georgia",12648,457,11304,460,9366,489,655,248,10649,465,1938,327,1344,248
"450","13125","Glascock County, Georgia",1045,89,875,106,587,111,60,38,815,107,288,77,170,61
"451","13127","Glynn County, Georgia",33401,794,30292,797,24401,825,1090,281,29202,793,5891,616,3109,549
"452","13129","Gordon County, Georgia",20183,382,18123,548,14502,635,852,224,17271,560,3621,443,2060,394
"453","13131","Grady County, Georgia",9760,302,8322,394,5791,418,312,112,8010,409,2531,314,1438,295
"454","13133","Greene County, Georgia",7324,284,6317,367,5191,310,334,141,5983,343,1126,231,1007,202
"455","13135","Gwinnett County, Georgia",313172,1267,303646,1565,275236,2363,6552,862,297094,1758,28410,1886,9526,1052
"456","13137","Habersham County, Georgia",15123,454,13159,521,10446,537,526,156,12633,495,2713,404,1964,339
"457","13139","Hall County, Georgia",67241,712,63336,823,53560,957,1990,362,61346,854,9776,775,3905,524
"458","13141","Hancock County, Georgia",2869,505,2001,509,1333,394,73,52,1928,503,668,231,868,175
"459","13143","Haralson County, Georgia",11240,262,10164,353,7653,467,412,162,9752,359,2511,402,1076,274
"460","13145","Harris County, Georgia",12194,381,11633,429,9894,464,367,141,11266,463,1739,304,561,168
"461","13147","Hart County, Georgia",10111,362,9144,423,6515,438,349,142,8795,428,2629,393,967,252
"462","13149","Heard County, Georgia",4285,170,3654,186,2641,209,220,73,3434,188,1013,189,631,127
"463","13151","Henry County, Georgia",80672,634,77851,758,70614,1039,2180,350,75671,786,7237,924,2821,452
"464","13153","Houston County, Georgia",59627,841,56306,957,48234,1057,1713,383,54593,1037,8072,879,3321,525
"465","13155","Irwin County, Georgia",3604,205,2958,243,2148,263,77,50,2881,245,810,174,646,151
"466","13157","Jackson County, Georgia",24874,359,23236,388,20055,560,679,167,22557,397,3181,489,1638,281
"467","13159","Jasper County, Georgia",5300,200,4583,237,3713,231,152,76,4431,252,870,193,717,166
"468","13161","Jeff Davis County, Georgia",5246,268,4552,328,3040,309,95,67,4457,335,1512,265,694,248
"469","13163","Jefferson County, Georgia",5625,274,4690,300,2959,283,154,69,4536,309,1731,240,935,175
"470","13165","Jenkins County, Georgia",3290,296,2729,290,1912,324,127,96,2602,290,817,207,561,212
"471","13167","Johnson County, Georgia",3201,304,2515,250,1683,217,171,77,2344,238,832,175,686,151
"472","13169","Jones County, Georgia",10444,286,9598,359,7601,427,434,166,9164,405,1997,323,846,243
"473","13171","Lamar County, Georgia",6811,276,6257,328,4723,344,193,86,6064,337,1534,309,554,187
"474","13173","Lanier County, Georgia",3529,193,2910,216,2350,233,75,54,2835,213,560,170,619,186
"475","13175","Laurens County, Georgia",17366,479,13970,504,10801,490,1764,261,12206,536,3169,346,3396,357
"476","13177","Lee County, Georgia",11616,231,11049,279,9900,305,464,168,10585,322,1149,232,567,142
"477","13179","Liberty County, Georgia",22554,515,21368,509,17469,624,648,147,20720,520,3899,481,1186,225
"478","13181","Lincoln County, Georgia",2953,188,2197,198,1641,171,206,85,1991,198,556,133,756,166
"479","13183","Long County, Georgia",5341,294,5133,298,3819,397,288,148,4845,315,1314,325,208,100
"480","13185","Lowndes County, Georgia",42512,631,37828,799,30277,949,1467,297,36361,828,7551,733,4684,542
"481","13187","Lumpkin County, Georgia",11102,343,10156,377,8870,446,592,182,9564,397,1286,322,946,266
"482","13189","McDuffie County, Georgia",8216,252,7102,379,5232,449,243,92,6859,387,1870,381,1114,282
"483","13191","McIntosh County, Georgia",4706,258,4189,247,3370,249,198,85,3991,260,819,211,517,142
"484","13193","Macon County, Georgia",3907,250,3025,256,2183,239,221,79,2804,265,842,181,882,183
"485","13195","Madison County, Georgia",10510,311,9516,339,7951,417,653,197,8863,353,1565,330,994,234
"486","13197","Marion County, Georgia",2924,176,2295,211,1714,189,184,79,2111,216,581,133,629,136
"487","13199","Meriwether County, Georgia",7895,316,6396,374,4513,368,449,153,5947,384,1883,282,1499,291
"488","13201","Miller County, Georgia",2531,112,1799,167,1232,186,37,24,1762,167,567,113,732,142
"489","13205","Mitchell County, Georgia",7946,325,6919,368,4023,441,259,89,6660,372,2896,490,1027,213
"490","13207","Monroe County, Georgia",10176,268,9417,299,7777,383,402,141,9015,348,1640,314,759,228
"491","13209","Montgomery County, Georgia",2857,200,2598,205,1796,192,111,40,2487,206,802,138,259,84
"492","13211","Morgan County, Georgia",7246,252,6613,286,5198,371,166,74,6447,288,1415,256,633,181
"493","13213","Murray County, Georgia",14431,373,12672,413,9365,524,621,179,12051,465,3307,440,1759,250
"494","13215","Muscogee County, Georgia",78491,912,71504,1042,55819,1270,2379,314,69125,1020,15685,867,6987,680
"495","13217","Newton County, Georgia",39342,439,37144,561,32655,812,1192,341,35952,631,4489,623,2198,407
"496","13219","Oconee County, Georgia",13965,305,13567,350,12405,428,448,170,13119,353,1162,255,398,123
"497","13221","Oglethorpe County, Georgia",5276,206,4508,232,3632,261,296,151,4212,261,876,199,768,172
"498","13223","Paulding County, Georgia",54961,709,52715,734,47553,1093,1435,354,51280,803,5162,845,2246,470
"499","13225","Peach County, Georgia",10209,417,8956,401,6903,495,416,139,8540,412,2053,423,1253,297
"500","13227","Pickens County, Georgia",12646,364,11829,430,9871,513,605,197,11224,485,1958,366,817,208
"501","13229","Pierce County, Georgia",7235,232,6823,257,4678,343,412,152,6411,286,2145,336,412,125
"502","13231","Pike County, Georgia",6200,153,5784,203,4657,253,235,77,5549,199,1127,207,416,116
"503","13233","Polk County, Georgia",15507,307,14007,377,10307,503,548,158,13459,411,3700,440,1500,292
"504","13235","Pulaski County, Georgia",3084,390,2773,381,2001,356,250,132,2523,347,772,208,311,110
"505","13237","Putnam County, Georgia",9499,459,8814,452,7241,505,699,300,8115,484,1573,320,685,259
"506","13239","Quitman County, Georgia",946,144,614,108,323,83,34,28,580,111,291,88,332,109
"507","13241","Rabun County, Georgia",6585,321,5813,325,4827,320,364,94,5449,331,986,189,772,144
"508","13243","Randolph County, Georgia",2402,210,2040,217,1168,203,122,63,1918,214,872,184,362,145
"509","13245","Richmond County, Georgia",73631,1133,67002,1301,51099,1402,3469,505,63533,1397,15903,1238,6629,538
"510","13247","Rockdale County, Georgia",32604,504,30929,618,26221,812,1072,278,29857,697,4708,593,1675,360
"511","13249","Schley County, Georgia",1600,148,1374,128,1124,141,98,48,1276,132,250,79,226,83
"512","13251","Screven County, Georgia",4707,220,3867,225,3052,240,230,87,3637,230,815,162,840,128
"513","13253","Seminole County, Georgia",3530,205,2808,203,1905,228,160,77,2648,206,903,196,722,209
"514","13255","Spalding County, Georgia",25852,379,22715,605,17863,752,1062,317,21653,617,4852,719,3137,468
"515","13257","Stephens County, Georgia",10037,397,8785,456,7025,475,591,175,8194,477,1760,315,1252,250
"516","13259","Stewart County, Georgia",1665,327,1370,308,812,189,73,47,1297,305,558,200,295,97
"517","13261","Sumter County, Georgia",10825,360,9709,398,6460,489,527,206,9182,454,3249,484,1116,208
"518","13263","Talbot County, Georgia",2549,104,2029,123,1374,136,112,48,1917,124,655,123,520,96
"519","13265","Taliaferro County, Georgia",605,104,448,99,338,89,29,17,419,98,110,42,157,46
"520","13267","Tattnall County, Georgia",7556,367,6584,406,5100,398,170,73,6414,401,1484,258,972,215
"521","13269","Taylor County, Georgia",3096,166,2541,191,1794,210,88,63,2453,202,747,206,555,115
"522","13271","Telfair County, Georgia",3020,276,2019,264,1618,227,440,129,1579,254,401,127,1001,200
"523","13273","Terrell County, Georgia",3344,162,2722,172,2066,195,167,76,2555,169,656,141,622,134
"524","13275","Thomas County, Georgia",17817,387,16121,428,12365,505,607,148,15514,449,3756,496,1696,299
"525","13277","Tift County, Georgia",15287,338,12380,511,9656,497,674,198,11706,484,2724,430,2907,420
"526","13279","Toombs County, Georgia",9779,382,8553,451,5891,417,524,190,8029,457,2662,417,1226,254
"527","13281","Towns County, Georgia",5323,339,4719,357,4003,345,189,68,4530,366,716,197,604,160
"528","13283","Treutlen County, Georgia",2236,228,1783,224,1091,174,89,56,1694,217,692,176,453,119
"529","13285","Troup County, Georgia",25216,467,22140,631,16762,805,1165,302,20975,672,5378,621,3076,474
"530","13287","Turner County, Georgia",3269,192,2693,257,1912,276,206,87,2487,265,781,256,576,196
"531","13289","Twiggs County, Georgia",2885,192,2239,209,1608,222,146,85,2093,211,631,140,646,123
"532","13291","Union County, Georgia",10172,483,8887,451,7527,450,618,131,8269,474,1360,313,1285,285
"533","13293","Upson County, Georgia",10364,281,9096,360,6981,455,626,174,8470,390,2115,401,1268,219
"534","13295","Walker County, Georgia",25629,507,23055,590,18157,814,1102,224,21953,612,4898,672,2574,425
"535","13297","Walton County, Georgia",33009,391,30970,495,26217,570,974,227,29996,510,4753,487,2039,443
"536","13299","Ware County, Georgia",12763,467,11652,499,7003,502,439,147,11213,524,4649,481,1111,228
"537","13301","Warren County, Georgia",1915,133,1471,130,908,142,69,32,1402,130,563,131,444,96
"538","13303","Washington County, Georgia",7153,275,5953,338,4181,339,346,109,5607,359,1772,297,1200,187
"539","13305","Wayne County, Georgia",10845,302,9610,336,6628,451,358,123,9252,352,2982,420,1235,228
"540","13307","Webster County, Georgia",929,142,758,115,528,119,30,25,728,113,230,64,171,95
"541","13309","Wheeler County, Georgia",1526,118,858,141,692,146,222,97,636,117,166,64,668,125
"542","13311","White County, Georgia",10251,387,9419,416,7483,485,468,191,8951,430,1936,347,832,212
"543","13313","Whitfield County, Georgia",35258,469,31511,693,23565,814,1254,366,30257,790,7946,794,3747,500
"544","13315","Wilcox County, Georgia",2446,152,1830,133,1303,146,236,86,1594,138,527,119,616,104
"545","13317","Wilkes County, Georgia",3988,202,2670,243,2020,244,389,132,2281,216,650,176,1318,252
"546","13319","Wilkinson County, Georgia",3206,172,2561,170,1861,173,374,104,2187,172,700,129,645,110
"547","13321","Worth County, Georgia",7806,253,7093,282,4947,336,305,131,6788,295,2146,326,713,145
"548","15001","Hawaii County, Hawaii",71402,942,65169,1143,54723,1284,4128,547,61041,1316,10446,810,6233,657
"549","15003","Honolulu County, Hawaii",330393,1438,311346,1588,272194,2155,10044,650,301302,1627,39152,1587,19047,941
"550","15005","Kalawao County, Hawaii",31,16,26,17,15,6,0,12,26,17,11,15,5,4
"551","15007","Kauai County, Hawaii",22668,507,21086,577,17711,586,746,230,20340,568,3375,361,1582,245
"552","15009","Maui County, Hawaii",53919,831,50360,954,43768,959,1471,219,48889,936,6592,533,3559,462
"553","16001","Ada County, Idaho",184806,997,177550,1318,164870,1732,6581,713,170969,1558,12680,1158,7256,726
"554","16003","Adams County, Idaho",1687,94,1527,113,1300,114,144,43,1383,112,227,83,160,61
"555","16005","Bannock County, Idaho",32062,422,29985,517,25953,644,1116,244,28869,576,4032,513,2077,330
"556","16007","Bear Lake County, Idaho",2231,135,2104,132,1684,133,103,38,2001,136,420,86,127,48
"557","16009","Benewah County, Idaho",3566,164,3111,168,2311,146,319,88,2792,191,800,202,455,122
"558","16011","Bingham County, Idaho",15640,258,14585,347,12058,427,756,188,13829,397,2527,342,1055,280
"559","16013","Blaine County, Idaho",8759,465,8638,471,7588,478,365,128,8273,505,1050,349,121,59
"560","16015","Boise County, Idaho",3277,237,3128,241,2860,235,282,130,2846,227,268,86,149,52
"561","16017","Bonner County, Idaho",18823,533,17420,556,14725,619,1350,287,16070,599,2695,382,1403,255
"562","16019","Bonneville County, Idaho",41693,418,39500,561,33674,725,1381,339,38119,586,5826,506,2193,381
"563","16021","Boundary County, Idaho",4503,225,4118,245,3386,275,209,83,3909,261,732,207,385,121
"564","16023","Butte County, Idaho",939,101,844,93,718,86,83,38,761,85,126,59,95,66
"565","16025","Camas County, Idaho",335,64,313,62,263,58,13,12,300,62,50,27,22,15
"566","16027","Canyon County, Idaho",76711,557,72392,654,61866,1066,3046,535,69346,857,10526,814,4319,424
"567","16029","Caribou County, Idaho",2470,124,2326,123,2027,122,143,60,2183,129,299,87,144,50
"568","16031","Cassia County, Idaho",8003,191,7430,245,6082,259,227,81,7203,244,1348,223,573,159
"569","16033","Clark County, Idaho",282,72,237,66,135,44,14,12,223,64,102,55,45,27
"570","16035","Clearwater County, Idaho",3474,155,3004,157,2518,152,341,81,2663,162,486,85,470,97
"571","16037","Custer County, Idaho",1716,178,1534,188,1379,178,134,91,1400,197,155,103,182,94
"572","16039","Elmore County, Idaho",10624,279,9969,333,8353,402,423,149,9546,351,1616,289,655,165
"573","16041","Franklin County, Idaho",4531,134,4311,156,3702,228,202,86,4109,187,609,161,220,92
"574","16043","Fremont County, Idaho",4288,157,3946,177,3447,199,106,52,3840,184,499,124,342,86
"575","16045","Gem County, Idaho",6943,203,6312,254,5261,315,458,148,5854,274,1051,274,631,167
"576","16047","Gooding County, Idaho",5407,166,4859,202,3785,239,343,122,4516,206,1074,224,548,124
"577","16049","Idaho County, Idaho",6387,255,5686,256,4972,249,648,165,5038,298,714,156,701,133
"578","16051","Jefferson County, Idaho",9345,223,9002,217,8085,277,160,80,8842,232,917,208,343,104
"579","16053","Jerome County, Idaho",7916,200,7369,237,5780,295,354,125,7015,245,1589,227,547,157
"580","16055","Kootenai County, Idaho",64914,718,61326,838,52798,1053,3124,506,58202,934,8528,808,3588,574
"581","16057","Latah County, Idaho",15706,330,15012,379,13795,410,741,148,14271,419,1217,215,694,164
"582","16059","Lemhi County, Idaho",3361,189,2998,234,2399,230,217,116,2781,236,599,203,363,146
"583","16061","Lewis County, Idaho",1556,42,1287,61,1084,58,155,33,1132,64,203,48,269,51
"584","16063","Lincoln County, Idaho",1798,54,1592,71,1219,93,79,28,1513,72,373,83,206,62
"585","16065","Madison County, Idaho",11289,356,11000,362,10061,406,215,104,10785,357,939,312,289,122
"586","16067","Minidoka County, Idaho",7363,212,6562,252,5068,266,266,88,6296,265,1494,263,801,158
"587","16069","Nez Perce County, Idaho",16848,292,15303,377,12755,424,823,244,14480,440,2548,315,1545,249
"588","16071","Oneida County, Idaho",1760,92,1643,107,1316,136,104,50,1539,111,327,101,117,55
"589","16073","Owyhee County, Idaho",4232,119,3710,188,2889,186,191,59,3519,179,821,173,522,171
"590","16075","Payette County, Idaho",9272,179,8502,280,7214,325,472,149,8030,275,1288,238,770,228
"591","16077","Power County, Idaho",2697,113,2486,130,2058,174,46,32,2440,127,428,163,211,97
"592","16079","Shoshone County, Idaho",5431,196,4798,211,3853,221,433,106,4365,209,945,150,633,110
"593","16081","Teton County, Idaho",4199,287,4066,274,3556,283,94,53,3972,262,510,148,133,90
"594","16083","Twin Falls County, Idaho",32455,395,30279,514,24997,707,1412,300,28867,503,5282,621,2176,362
"595","16085","Valley County, Idaho",3690,349,3621,349,3239,364,117,92,3504,375,382,171,69,40
"596","16087","Washington County, Idaho",4112,121,3721,143,2908,223,365,109,3356,164,813,176,391,113
"597","17001","Adams County, Illinois",27174,334,23770,529,19341,599,1150,206,22620,543,4429,386,3404,416
"598","17003","Alexander County, Illinois",1781,115,1285,116,574,90,60,26,1225,113,711,102,496,82
"599","17005","Bond County, Illinois",6094,374,5394,385,4321,383,333,82,5061,369,1073,236,700,153
"600","17007","Boone County, Illinois",18897,331,17619,435,15676,487,733,205,16886,464,1943,372,1278,328
"601","17009","Brown County, Illinois",1998,146,1670,198,1242,183,66,31,1604,208,428,141,328,106
"602","17011","Bureau County, Illinois",13788,254,12386,295,10090,318,695,130,11691,279,2296,234,1402,181
"603","17013","Calhoun County, Illinois",1272,76,1060,84,785,82,97,34,963,87,275,59,212,58
"604","17015","Carroll County, Illinois",6299,233,5654,258,4651,252,527,117,5127,251,1003,139,645,137
"605","17017","Cass County, Illinois",4983,161,4332,186,3313,196,238,75,4094,176,1019,160,651,106
"606","17019","Champaign County, Illinois",81835,979,77447,1043,68852,1055,2552,337,74895,1072,8595,793,4388,457
"607","17021","Christian County, Illinois",13567,353,12015,393,10022,448,821,151,11194,397,1993,274,1552,216
"608","17023","Clark County, Illinois",6379,209,5695,215,4507,243,196,64,5499,216,1188,197,684,128
"609","17025","Clay County, Illinois",5447,195,4889,216,3900,225,498,170,4391,234,989,181,558,143
"610","17027","Clinton County, Illinois",14255,262,12787,319,10893,348,803,160,11984,330,1894,279,1468,198
"611","17029","Coles County, Illinois",20269,440,18746,490,15263,516,858,163,17888,483,3483,350,1523,252
"612","17031","Cook County, Illinois",2044658,3765,1892469,4364,1613541,5623,65415,2298,1827054,4579,278928,4044,152189,3262
"613","17033","Crawford County, Illinois",7512,333,6702,350,5071,355,288,70,6414,338,1631,248,810,149
"614","17035","Cumberland County, Illinois",4126,148,3685,181,2980,189,187,64,3498,187,705,154,441,107
"615","17037","DeKalb County, Illinois",38931,382,37045,516,32150,637,1412,276,35633,546,4895,534,1886,350
"616","17039","De Witt County, Illinois",6635,142,5947,192,4844,224,348,115,5599,220,1103,204,688,149
"617","17041","Douglas County, Illinois",7585,152,6430,181,5303,237,361,79,6069,192,1127,165,1155,145
"618","17043","DuPage County, Illinois",347385,1149,332915,1469,306425,1737,11067,750,321848,1509,26490,1143,14470,854
"619","17045","Edgar County, Illinois",7544,179,6748,194,4939,272,302,83,6446,207,1809,247,796,166
"620","17047","Edwards County, Illinois",2656,101,2305,107,1701,129,153,40,2152,107,604,101,351,74
"621","17049","Effingham County, Illinois",14104,263,12980,305,10591,396,809,173,12171,349,2389,313,1124,142
"622","17051","Fayette County, Illinois",7609,202,6423,249,4587,255,364,73,6059,244,1836,183,1186,166
"623","17053","Ford County, Illinois",5719,145,5208,171,4291,188,428,104,4780,187,917,158,511,110
"624","17055","Franklin County, Illinois",16237,326,14356,339,10478,316,775,195,13581,346,3878,344,1881,211
"625","17057","Fulton County, Illinois",13893,326,12192,357,9691,317,719,143,11473,351,2501,292,1701,232
"626","17059","Gallatin County, Illinois",2133,80,1710,118,1059,137,121,59,1589,108,651,116,423,96
"627","17061","Greene County, Illinois",4512,168,3903,163,2482,170,280,60,3623,170,1421,182,609,94
"628","17063","Grundy County, Illinois",20159,229,19080,322,16636,383,942,199,18138,353,2444,315,1079,224
"629","17065","Hamilton County, Illinois",3190,148,2618,169,2040,180,113,51,2505,169,578,150,572,119
"630","17067","Hancock County, Illinois",7368,176,6310,232,5476,226,450,96,5860,241,834,135,1058,139
"631","17069","Hardin County, Illinois",1501,136,1248,131,856,137,69,38,1179,138,392,106,253,61
"632","17071","Henderson County, Illinois",2696,123,2328,140,1817,155,215,67,2113,142,511,100,368,85
"633","17073","Henry County, Illinois",20109,340,17846,417,14386,478,1015,184,16831,402,3460,423,2263,279
"634","17075","Iroquois County, Illinois",11242,221,10028,207,8115,247,537,94,9491,218,1913,195,1214,138
"635","17077","Jackson County, Illinois",23186,541,21336,572,16992,657,689,155,20647,592,4344,507,1850,273
"636","17079","Jasper County, Illinois",3745,145,3379,184,2764,199,106,46,3273,188,615,125,366,99
"637","17081","Jefferson County, Illinois",14608,349,13125,415,9895,402,651,97,12474,428,3230,355,1483,216
"638","17083","Jersey County, Illinois",7818,255,6699,319,4866,291,455,128,6244,296,1833,248,1119,240
"639","17085","Jo Daviess County, Illinois",10006,296,9034,297,7888,325,667,143,8367,321,1146,159,972,163
"640","17087","Johnson County, Illinois",4055,204,3327,202,2327,182,158,49,3169,200,1000,149,728,125
"641","17089","Kane County, Illinois",181263,811,172937,1036,152689,1383,6516,901,166421,1337,20248,939,8326,739
"642","17091","Kankakee County, Illinois",40346,574,36577,626,29316,715,1897,268,34680,700,7261,689,3769,326
"643","17093","Kendall County, Illinois",43225,428,42122,488,37688,865,1175,323,40947,573,4434,835,1103,298
"644","17095","Knox County, Illinois",20575,392,17550,508,13560,528,1098,152,16452,500,3990,368,3025,346
"645","17097","Lake County, Illinois",252731,1028,241664,1361,216912,1815,8129,793,233535,1530,24752,1335,11067,910
"646","17099","LaSalle County, Illinois",44873,528,40862,588,33291,746,2204,323,38658,602,7571,585,4011,375
"647","17101","Lawrence County, Illinois",5449,250,4949,248,3687,237,171,47,4778,254,1262,210,500,93
"648","17103","Lee County, Illinois",13508,333,12038,352,9637,402,657,139,11381,411,2401,338,1470,234
"649","17105","Livingston County, Illinois",14431,254,13060,266,10618,364,848,176,12212,304,2442,300,1371,163
"650","17107","Logan County, Illinois",11003,251,10031,264,8083,309,378,106,9653,274,1948,248,972,135
"651","17109","McDonough County, Illinois",11247,384,9695,401,8245,377,495,115,9200,399,1450,247,1552,250
"652","17111","McHenry County, Illinois",114446,613,110677,677,100689,893,3984,467,106693,702,9988,753,3769,420
"653","17113","McLean County, Illinois",67900,1017,64577,1135,56618,1255,2000,301,62577,1103,7959,640,3323,458
"654","17115","Macon County, Illinois",43264,660,38712,734,30751,824,2025,334,36687,798,7961,654,4552,475
"655","17117","Macoupin County, Illinois",17649,333,15784,387,11457,430,985,190,14799,412,4327,353,1865,245
"656","17119","Madison County, Illinois",108237,1109,99898,1271,83953,1347,4591,412,95307,1254,15945,855,8339,645
"657","17121","Marion County, Illinois",15294,253,13705,282,10010,356,709,142,12996,292,3695,363,1589,204
"658","17123","Marshall County, Illinois",4892,144,4340,157,3396,158,246,51,4094,158,944,118,552,87
"659","17125","Mason County, Illinois",5790,160,5161,204,4033,231,317,78,4844,203,1128,165,629,121
"660","17127","Massac County, Illinois",5466,251,4605,266,2642,260,166,57,4439,280,1963,273,861,155
"661","17129","Menard County, Illinois",5114,120,4752,131,3942,173,128,43,4624,135,810,131,362,77
"662","17131","Mercer County, Illinois",6339,177,5671,206,4824,201,297,72,5374,213,847,162,668,144
"663","17133","Monroe County, Illinois",13479,236,12529,300,11370,379,736,178,11793,332,1159,269,950,193
"664","17135","Montgomery County, Illinois",11145,501,9582,517,7642,489,558,121,9024,521,1940,293,1563,220
"665","17137","Morgan County, Illinois",13187,324,11501,375,8347,437,767,127,10734,388,3154,396,1686,260
"666","17139","Moultrie County, Illinois",5753,134,5041,162,3928,203,290,83,4751,189,1113,198,712,146
"667","17141","Ogle County, Illinois",20771,354,18556,410,15783,480,1030,225,17526,407,2773,297,2215,316
"668","17143","Peoria County, Illinois",75352,796,68652,913,54063,1174,2536,347,66116,946,14589,792,6700,567
"669","17145","Perry County, Illinois",8108,212,7309,232,5569,324,294,104,7015,257,1740,285,799,154
"670","17147","Piatt County, Illinois",6686,164,6203,188,5141,214,247,105,5956,199,1062,191,483,100
"671","17149","Pike County, Illinois",5756,184,4904,208,3523,214,338,105,4566,202,1381,166,852,141
"672","17151","Pope County, Illinois",1372,113,1027,113,548,104,83,42,944,102,479,109,345,94
"673","17153","Pulaski County, Illinois",1857,112,1241,115,613,90,65,30,1176,114,628,99,616,96
"674","17155","Putnam County, Illinois",2298,132,2099,137,1669,120,149,45,1950,148,430,79,199,49
"675","17157","Randolph County, Illinois",11538,313,10252,318,7618,377,453,99,9799,305,2634,252,1286,178
"676","17159","Richland County, Illinois",6381,226,5794,205,4479,240,531,142,5263,233,1315,197,587,92
"677","17161","Rock Island County, Illinois",60694,572,55774,668,44545,820,2248,230,53526,682,11229,686,4920,433
"678","17163","St. Clair County, Illinois",100079,939,91424,1036,73850,1375,4080,430,87344,1052,17574,1184,8655,596
"679","17165","Saline County, Illinois",10026,230,8347,294,6001,325,448,125,7899,303,2346,292,1679,247
"680","17167","Sangamon County, Illinois",84630,717,77604,804,63478,1099,3644,421,73960,857,14126,977,7026,575
"681","17169","Schuyler County, Illinois",2692,231,2441,216,2014,231,229,73,2212,215,427,124,251,75
"682","17171","Scott County, Illinois",1943,91,1714,85,1238,88,72,25,1642,84,476,99,229,52
"683","17173","Shelby County, Illinois",8768,248,7661,312,5944,349,505,120,7156,329,1717,213,1107,196
"684","17175","Stark County, Illinois",2262,99,1982,103,1558,108,115,42,1867,104,424,65,280,59
"685","17177","Stephenson County, Illinois",19253,335,17093,410,14207,509,1411,223,15682,454,2886,358,2160,301
"686","17179","Tazewell County, Illinois",53719,585,49306,680,41453,791,2110,281,47196,699,7853,657,4413,441
"687","17181","Union County, Illinois",6702,219,5362,320,3415,318,304,106,5058,317,1947,278,1340,258
"688","17183","Vermilion County, Illinois",29747,467,25697,566,19181,647,1753,241,23944,586,6516,526,4050,402
"689","17185","Wabash County, Illinois",4731,182,4182,188,3093,216,203,65,3979,195,1089,193,549,118
"690","17187","Warren County, Illinois",6818,237,6182,290,4868,303,282,77,5900,286,1314,222,636,164
"691","17189","Washington County, Illinois",5811,153,5256,163,4199,217,374,84,4882,165,1057,141,555,82
"692","17191","Wayne County, Illinois",6796,159,5650,189,4443,239,513,96,5137,161,1207,146,1146,159
"693","17193","White County, Illinois",5690,221,4914,231,3743,228,247,86,4667,239,1171,172,776,142
"694","17195","Whiteside County, Illinois",23194,351,20613,414,16695,458,1177,293,19436,451,3918,330,2581,301
"695","17197","Will County, Illinois",237043,874,226533,1044,201174,1507,6872,519,219661,1117,25359,1251,10510,770
"696","17199","Williamson County, Illinois",28057,506,24520,691,18311,680,1019,188,23501,670,6209,575,3537,480
"697","17201","Winnebago County, Illinois",115240,738,105646,1098,84980,1365,5176,451,100470,1120,20666,1081,9594,803
"698","17203","Woodford County, Illinois",14675,262,13744,263,11987,326,731,175,13013,302,1757,247,931,154
"699","18001","Adams County, Indiana",12279,244,9924,364,7803,421,566,121,9358,355,2121,319,2355,319
"700","18003","Allen County, Indiana",149751,675,140024,952,116150,1327,5866,436,134158,964,23874,1063,9727,718
"701","18005","Bartholomew County, Indiana",32303,471,29747,541,24831,622,1193,207,28554,546,4916,593,2556,380
"702","18007","Benton County, Indiana",3319,128,3036,135,2366,150,263,78,2773,129,670,130,283,70
"703","18009","Blackford County, Indiana",4963,187,4340,227,3170,281,325,84,4015,209,1170,207,623,128
"704","18011","Boone County, Indiana",26130,381,25080,456,22446,651,836,202,24244,436,2634,463,1050,243
"705","18013","Brown County, Indiana",6304,242,5773,259,4720,285,392,113,5381,263,1053,219,531,152
"706","18015","Carroll County, Indiana",7876,203,7165,233,5156,250,434,115,6731,217,2009,260,711,160
"707","18017","Cass County, Indiana",15007,268,13466,342,9732,418,868,196,12598,430,3734,434,1541,267
"708","18019","Clark County, Indiana",46417,581,42973,716,35284,838,2010,365,40963,738,7689,664,3444,504
"709","18021","Clay County, Indiana",10478,276,9563,297,7401,312,485,141,9078,314,2162,300,915,173
"710","18023","Clinton County, Indiana",12146,270,11023,340,7636,344,513,104,10510,337,3387,321,1123,232
"711","18025","Crawford County, Indiana",4186,174,3423,233,2368,221,205,90,3218,237,1055,194,763,146
"712","18027","Daviess County, Indiana",11621,241,9607,275,6937,349,374,92,9233,259,2670,289,2014,229
"713","18029","Dearborn County, Indiana",19499,256,17750,369,15157,449,1242,251,16508,420,2593,397,1749,274
"714","18031","Decatur County, Indiana",10176,252,9312,315,7508,356,360,112,8952,300,1804,277,864,171
"715","18033","DeKalb County, Indiana",16832,284,15040,359,12590,404,1041,231,13999,417,2450,326,1792,299
"716","18035","Delaware County, Indiana",45602,598,41729,678,33786,856,2138,335,39591,723,7943,604,3873,418
"717","18037","Dubois County, Indiana",17274,367,15554,488,12211,513,973,221,14581,473,3343,430,1720,290
"718","18039","Elkhart County, Indiana",71343,742,64817,805,51218,1058,2965,343,61852,887,13599,908,6526,498
"719","18041","Fayette County, Indiana",9677,240,8663,285,6527,309,383,117,8280,290,2136,246,1014,189
"720","18043","Floyd County, Indiana",30137,497,27743,543,23626,635,1062,208,26681,566,4117,429,2394,349
"721","18045","Fountain County, Indiana",6843,199,6289,214,4646,238,437,100,5852,222,1643,215,554,111
"722","18047","Franklin County, Indiana",8896,226,7728,272,6137,289,262,86,7466,300,1591,221,1168,210
"723","18049","Fulton County, Indiana",7896,271,7054,291,5601,318,433,132,6621,304,1453,264,842,184
"724","18051","Gibson County, Indiana",12896,318,11669,357,8938,418,561,124,11108,394,2731,276,1227,194
"725","18053","Grant County, Indiana",26299,486,23665,525,18037,608,1502,283,22163,549,5628,581,2634,337
"726","18055","Greene County, Indiana",12472,261,10985,286,8240,377,617,159,10368,295,2745,299,1487,239
"727","18057","Hamilton County, Indiana",126371,734,123734,845,116318,1221,2321,368,121413,921,7416,763,2637,418
"728","18059","Hancock County, Indiana",30840,303,29279,392,25960,596,1010,265,28269,457,3319,506,1561,315
"729","18061","Harrison County, Indiana",14437,382,12958,406,10396,435,651,178,12307,405,2562,372,1479,279
"730","18063","Hendricks County, Indiana",62911,619,61083,651,54469,1074,1651,314,59432,689,6614,883,1828,342
"731","18065","Henry County, Indiana",18442,347,16625,367,13409,455,902,162,15723,395,3216,351,1817,246
"732","18067","Howard County, Indiana",34674,499,31760,648,25430,819,1462,216,30298,653,6330,574,2914,450
"733","18069","Huntington County, Indiana",14928,264,13499,336,10679,379,613,144,12886,346,2820,304,1429,232
"734","18071","Jackson County, Indiana",17159,348,15005,439,12117,441,716,152,14289,444,2888,334,2154,313
"735","18073","Jasper County, Indiana",12493,225,11478,279,9450,381,530,161,10948,293,2028,346,1015,197
"736","18075","Jay County, Indiana",8146,172,6913,228,5046,251,391,110,6522,240,1867,233,1233,187
"737","18077","Jefferson County, Indiana",12748,401,11228,456,8706,493,678,185,10550,432,2522,386,1520,281
"738","18079","Jennings County, Indiana",10217,311,9263,342,7351,420,349,98,8914,350,1912,306,954,206
"739","18081","Johnson County, Indiana",59475,497,56500,610,50011,821,1770,245,54730,600,6489,598,2975,391
"740","18083","Knox County, Indiana",15111,376,13490,388,10127,464,732,149,12758,445,3363,450,1621,212
"741","18085","Kosciusko County, Indiana",31012,477,28508,552,23543,643,1536,208,26972,564,4965,464,2504,403
"742","18087","LaGrange County, Indiana",12599,309,8959,341,6582,354,578,155,8381,347,2377,269,3640,270
"743","18089","Lake County, Indiana",190191,1007,172884,1330,138720,1790,8414,693,164470,1339,34164,1533,17307,906
"744","18091","LaPorte County, Indiana",43256,568,39742,641,32312,749,2459,309,37283,708,7430,581,3514,396
"745","18093","Lawrence County, Indiana",18723,360,16129,458,12396,574,922,222,15207,440,3733,421,2594,352
"746","18095","Madison County, Indiana",51355,701,46546,826,36448,873,2100,260,44446,864,10098,760,4809,442
"747","18097","Marion County, Indiana",388366,1923,353475,2675,289943,3303,13526,767,339949,2619,63532,2409,34891,1641
"748","18099","Marshall County, Indiana",16865,319,14416,394,11811,426,869,212,13547,425,2605,405,2449,298
"749","18101","Martin County, Indiana",3944,157,3398,184,2480,171,244,79,3154,188,918,190,546,125
"750","18103","Miami County, Indiana",13148,251,11830,306,9122,374,559,103,11271,334,2708,347,1318,199
"751","18105","Monroe County, Indiana",57160,701,54606,709,48508,936,1883,336,52723,712,6098,611,2554,338
"752","18107","Montgomery County, Indiana",15420,229,14309,290,11347,403,726,161,13583,346,2962,318,1111,245
"753","18109","Morgan County, Indiana",26926,353,24781,470,20333,610,1251,225,23530,495,4448,430,2145,324
"754","18111","Newton County, Indiana",5489,147,5112,153,4059,246,478,140,4634,191,1053,201,377,91
"755","18113","Noble County, Indiana",17702,353,15571,495,12320,519,661,156,14910,495,3251,347,2131,388
"756","18115","Ohio County, Indiana",2548,80,2213,105,1810,134,186,75,2027,123,403,91,335,91
"757","18117","Orange County, Indiana",7948,223,6918,246,5151,296,519,174,6399,250,1767,240,1030,161
"758","18119","Owen County, Indiana",8444,206,7413,219,5340,320,566,174,6847,226,2073,265,1031,176
"759","18121","Parke County, Indiana",5519,337,4482,336,3524,291,233,85,4249,324,958,194,1037,174
"760","18123","Perry County, Indiana",7526,214,6602,254,5293,316,432,108,6170,275,1309,198,924,148
"761","18125","Pike County, Indiana",5127,134,4432,178,3221,199,191,58,4241,189,1211,168,695,130
"762","18127","Porter County, Indiana",67009,620,62957,756,54517,973,2272,398,60685,772,8440,772,4052,526
"763","18129","Posey County, Indiana",10059,238,9370,251,7602,306,332,98,9038,269,1768,227,689,145
"764","18131","Pulaski County, Indiana",4845,200,4317,238,3481,241,404,130,3913,249,836,133,528,164
"765","18133","Putnam County, Indiana",13474,269,12425,355,9916,435,695,134,11730,352,2509,382,1049,218
"766","18135","Randolph County, Indiana",10166,240,9141,290,7203,314,512,122,8629,269,1938,242,1025,195
"767","18137","Ripley County, Indiana",11127,231,9856,312,8089,335,602,132,9254,345,1767,230,1271,225
"768","18139","Rush County, Indiana",6642,188,6012,194,4449,269,284,73,5728,209,1563,221,630,130
"769","18141","St. Joseph County, Indiana",106330,829,97214,1120,81618,1460,6243,663,90971,1206,15596,917,9116,713
"770","18143","Scott County, Indiana",9526,242,8160,411,6103,406,576,138,7584,417,2057,340,1366,323
"771","18145","Shelby County, Indiana",17818,293,16093,412,12759,459,674,184,15419,394,3334,364,1725,300
"772","18147","Spencer County, Indiana",7870,173,6857,229,5301,236,417,107,6440,244,1556,208,1013,173
"773","18149","Starke County, Indiana",8474,237,7205,273,5713,285,507,125,6698,292,1492,265,1269,226
"774","18151","Steuben County, Indiana",13689,350,12348,408,10063,411,565,106,11783,434,2285,320,1341,213
"775","18153","Sullivan County, Indiana",7575,206,6618,287,4985,356,292,78,6326,284,1633,255,957,224
"776","18155","Switzerland County, Indiana",3704,159,3002,187,2197,194,117,47,2885,175,805,163,702,135
"777","18157","Tippecanoe County, Indiana",71801,919,68815,967,54160,1270,1805,243,67010,969,14655,1037,2986,371
"778","18159","Tipton County, Indiana",6155,216,5746,227,4457,259,213,95,5533,242,1289,224,409,136
"779","18161","Union County, Indiana",2820,99,2563,108,2052,148,168,72,2395,135,511,114,257,78
"780","18163","Vanderburgh County, Indiana",76549,874,70204,1043,55732,1124,2899,421,67305,1103,14472,776,6345,484
"781","18165","Vermillion County, Indiana",6447,248,6003,269,4584,294,384,105,5619,279,1419,220,444,101
"782","18167","Vigo County, Indiana",42595,614,39364,689,31314,815,1751,247,37613,698,8050,650,3231,481
"783","18169","Wabash County, Indiana",12538,349,11443,373,8807,449,788,157,10655,396,2636,356,1095,238
"784","18171","Warren County, Indiana",3342,131,3104,150,2335,162,162,54,2942,157,769,121,238,78
"785","18173","Warrick County, Indiana",24327,343,23172,413,19343,511,648,170,22524,424,3829,428,1155,222
"786","18175","Washington County, Indiana",10641,255,8936,325,6928,377,553,136,8383,335,2008,299,1705,255
"787","18177","Wayne County, Indiana",26837,481,24052,546,18682,642,1435,239,22617,607,5370,593,2785,349
"788","18179","Wells County, Indiana",11120,234,10032,336,8037,378,508,136,9524,369,1995,249,1088,213
"789","18181","White County, Indiana",9554,277,8784,296,6682,346,603,151,8181,277,2102,257,770,164
"790","18183","Whitley County, Indiana",13725,279,12823,304,10962,383,687,150,12136,327,1861,301,902,176
"791","19001","Adair County, Iowa",3180,114,2761,131,2228,135,163,40,2598,130,533,89,419,86
"792","19003","Adams County, Iowa",1529,94,1361,94,1171,87,100,33,1261,97,190,52,168,40
"793","19005","Allamakee County, Iowa",5814,178,4888,215,4085,205,473,82,4415,233,803,141,926,152
"794","19007","Appanoose County, Iowa",4920,207,4339,214,3383,201,473,123,3866,240,956,165,581,110
"795","19009","Audubon County, Iowa",2498,80,2180,93,1801,126,135,45,2045,89,379,84,318,78
"796","19011","Benton County, Iowa",10075,224,9339,222,7918,250,567,117,8772,243,1421,185,736,141
"797","19013","Black Hawk County, Iowa",53465,505,49092,597,40018,922,2455,344,46637,667,9074,835,4373,411
"798","19015","Boone County, Iowa",10720,232,9901,239,8242,247,459,118,9442,255,1659,252,819,140
"799","19017","Bremer County, Iowa",9638,191,8897,227,7501,281,437,79,8460,229,1396,181,741,147
"800","19019","Buchanan County, Iowa",7787,210,6980,193,5878,239,298,92,6682,201,1102,177,807,118
"801","19021","Buena Vista County, Iowa",7506,174,7007,194,5376,261,383,119,6624,221,1631,247,499,130
"802","19023","Butler County, Iowa",5860,140,5051,156,4131,174,362,74,4689,171,920,137,809,124
"803","19025","Calhoun County, Iowa",3932,134,3514,134,2927,131,292,58,3222,136,587,78,418,68
"804","19027","Carroll County, Iowa",8761,225,7802,243,6578,267,551,126,7251,246,1224,165,959,152
"805","19029","Cass County, Iowa",5777,176,5207,172,4243,203,302,89,4905,173,964,162,570,104
"806","19031","Cedar County, Iowa",7381,197,6422,236,5564,227,390,73,6032,231,858,130,959,168
"807","19033","Cerro Gordo County, Iowa",19569,391,17423,488,13795,524,1173,232,16250,530,3628,420,2146,338
"808","19035","Cherokee County, Iowa",5126,163,4406,223,3541,246,335,109,4071,215,865,167,720,151
"809","19037","Chickasaw County, Iowa",5005,143,4431,141,3497,136,318,78,4113,137,934,145,574,101
"810","19039","Clarke County, Iowa",3740,185,3358,205,2558,234,147,75,3211,197,800,200,382,109
"811","19041","Clay County, Iowa",7137,225,6564,248,5192,290,344,129,6220,255,1372,228,573,139
"812","19043","Clayton County, Iowa",7319,199,6330,231,5070,248,530,94,5800,236,1260,200,989,146
"813","19045","Clinton County, Iowa",19103,326,16590,442,13957,552,966,173,15624,462,2633,276,2513,361
"814","19047","Crawford County, Iowa",6159,194,5550,234,4104,258,335,95,5215,241,1446,264,609,130
"815","19049","Dallas County, Iowa",37970,488,36425,518,32672,676,834,201,35591,560,3753,498,1545,284
"816","19051","Davis County, Iowa",3150,129,2399,155,2011,155,222,65,2177,160,388,80,751,162
"817","19053","Decatur County, Iowa",3053,130,2675,144,2182,151,160,43,2515,150,493,96,378,67
"818","19055","Delaware County, Iowa",6944,232,6121,237,5041,264,282,103,5839,241,1080,216,823,151
"819","19057","Des Moines County, Iowa",17042,274,15223,326,12061,428,1216,219,14007,387,3162,428,1819,251
"820","19059","Dickinson County, Iowa",8096,252,7476,299,6325,276,440,103,7036,332,1151,226,620,157
"821","19061","Dubuque County, Iowa",39534,392,36514,452,30588,563,1810,232,34704,533,5926,520,3020,336
"822","19063","Emmet County, Iowa",3856,155,3522,157,2600,189,227,64,3295,171,922,189,334,87
"823","19065","Fayette County, Iowa",8107,211,7185,238,5795,233,596,101,6589,232,1390,192,922,119
"824","19067","Floyd County, Iowa",6712,192,5742,252,4479,266,415,116,5327,255,1263,234,970,207
"825","19069","Franklin County, Iowa",4108,177,3432,183,2676,173,228,72,3204,182,756,157,676,154
"826","19071","Fremont County, Iowa",2742,95,2479,93,2018,113,126,34,2353,103,461,83,263,56
"827","19073","Greene County, Iowa",3790,150,3517,156,2816,169,219,69,3298,175,701,121,273,60
"828","19075","Grundy County, Iowa",5024,109,4508,135,3885,145,278,62,4230,132,623,104,516,83
"829","19077","Guthrie County, Iowa",4463,157,4053,162,3328,180,197,57,3856,164,725,116,410,86
"830","19079","Hamilton County, Iowa",5993,244,5177,251,4440,264,393,100,4784,259,737,165,816,168
"831","19081","Hancock County, Iowa",4610,118,4069,142,3215,192,239,78,3830,149,854,146,541,110
"832","19083","Hardin County, Iowa",7033,193,5976,244,4935,288,504,108,5472,243,1041,161,1057,185
"833","19085","Harrison County, Iowa",5932,142,5371,162,4409,172,335,69,5036,178,962,133,561,112
"834","19087","Henry County, Iowa",7565,221,6778,237,5687,233,427,87,6351,257,1091,163,787,138
"835","19089","Howard County, Iowa",3708,172,3277,188,2634,187,230,55,3047,190,643,138,431,93
"836","19091","Humboldt County, Iowa",4189,98,3606,116,3019,160,196,53,3410,125,587,116,583,87
"837","19093","Ida County, Iowa",2951,96,2611,114,2040,134,151,40,2460,121,571,124,340,73
"838","19095","Iowa County, Iowa",6765,153,6133,192,5290,185,320,67,5813,200,843,147,632,118
"839","19097","Jackson County, Iowa",8020,207,6822,223,5796,188,460,104,6362,228,1026,156,1198,191
"840","19099","Jasper County, Iowa",14370,349,12972,397,10451,403,613,147,12359,392,2521,309,1398,229
"841","19101","Jefferson County, Iowa",6688,313,6201,317,5316,307,529,180,5672,349,885,194,487,164
"842","19103","Johnson County, Iowa",60573,768,58246,877,53524,988,1958,351,56288,948,4722,557,2327,375
"843","19105","Jones County, Iowa",8053,196,7011,296,6006,324,436,98,6575,305,1005,186,1042,250
"844","19107","Keokuk County, Iowa",4136,97,3625,123,2893,130,200,39,3425,127,732,116,511,79
"845","19109","Kossuth County, Iowa",6422,143,5626,202,4644,203,400,123,5226,208,982,131,796,141
"846","19111","Lee County, Iowa",14068,262,12676,303,9965,387,750,156,11926,311,2711,310,1392,179
"847","19113","Linn County, Iowa",93602,691,88354,773,76978,1090,3219,327,85135,828,11376,764,5248,495
"848","19115","Louisa County, Iowa",4043,146,3587,152,2913,162,155,49,3432,151,674,116,456,94
"849","19117","Lucas County, Iowa",3614,124,3121,146,2265,187,200,60,2921,144,856,135,493,117
"850","19119","Lyon County, Iowa",4364,113,4009,126,3397,149,310,98,3699,139,612,114,355,74
"851","19121","Madison County, Iowa",6377,157,5884,202,5033,213,291,101,5593,222,851,215,493,141
"852","19123","Mahaska County, Iowa",8813,210,7944,261,6144,309,355,92,7589,255,1800,273,869,158
"853","19125","Marion County, Iowa",13241,226,12071,266,9944,368,534,127,11537,252,2127,273,1170,174
"854","19127","Marshall County, Iowa",15298,306,13728,362,10625,360,651,145,13077,343,3103,330,1570,233
"855","19129","Mills County, Iowa",5301,196,4962,204,4283,221,327,106,4635,217,679,157,339,87
"856","19131","Mitchell County, Iowa",4400,121,3870,152,3361,157,259,74,3611,171,509,104,530,102
"857","19133","Monona County, Iowa",3786,134,3321,134,2598,155,301,83,3020,145,723,132,465,88
"858","19135","Monroe County, Iowa",2998,142,2757,149,2131,156,154,64,2603,163,626,120,241,79
"859","19137","Montgomery County, Iowa",4380,175,3895,190,3115,216,226,63,3669,186,780,167,485,109
"860","19139","Muscatine County, Iowa",16785,268,15300,348,12572,424,907,194,14393,371,2728,353,1485,278
"861","19141","O'Brien County, Iowa",5670,220,5111,242,4261,257,384,108,4727,252,850,157,559,129
"862","19143","Osceola County, Iowa",2659,83,2409,94,1983,108,217,69,2192,104,426,94,250,63
"863","19145","Page County, Iowa",6171,267,5535,279,4327,262,417,100,5118,272,1208,177,636,161
"864","19147","Palo Alto County, Iowa",3685,164,3325,161,2710,147,202,57,3123,161,615,113,360,87
"865","19149","Plymouth County, Iowa",10191,178,9271,277,7960,314,404,91,8867,290,1311,210,920,219
"866","19151","Pocahontas County, Iowa",3121,96,2851,100,2321,127,352,79,2499,122,530,89,270,65
"867","19153","Polk County, Iowa",195263,1007,184854,1240,157503,1913,7158,517,177696,1242,27351,1270,10409,732
"868","19155","Pottawattamie County, Iowa",36964,488,33547,555,27749,654,1978,221,31569,575,5798,522,3417,332
"869","19157","Poweshiek County, Iowa",7820,249,7085,280,5606,308,492,163,6593,261,1479,232,735,139
"870","19159","Ringgold County, Iowa",1860,108,1597,109,1293,114,98,33,1499,108,304,68,263,53
"871","19161","Sac County, Iowa",4196,117,3703,121,3026,139,392,80,3311,133,677,98,493,81
"872","19163","Scott County, Iowa",69955,619,63990,758,54803,917,2446,302,61544,771,9187,688,5965,502
"873","19165","Shelby County, Iowa",4918,355,4319,339,3525,238,360,93,3959,319,794,269,599,128
"874","19167","Sioux County, Iowa",12284,211,11571,275,9913,329,634,182,10937,309,1658,306,713,175
"875","19169","Story County, Iowa",37944,566,36359,629,33147,754,1400,261,34959,636,3212,413,1585,315
"876","19171","Tama County, Iowa",6655,167,6049,191,4701,222,466,89,5583,202,1348,175,606,104
"877","19173","Taylor County, Iowa",2446,76,2179,87,1707,99,192,54,1987,94,472,65,267,44
"878","19175","Union County, Iowa",4936,193,4459,216,3637,225,465,117,3994,230,822,146,477,112
"879","19177","Van Buren County, Iowa",2858,144,2306,149,1726,136,129,40,2177,151,580,85,552,86
"880","19179","Wapello County, Iowa",14120,268,12538,338,9770,422,625,121,11913,363,2768,300,1582,254
"881","19181","Warren County, Iowa",19517,245,18552,292,16104,404,882,139,17670,294,2448,338,965,167
"882","19183","Washington County, Iowa",8833,195,8041,243,6775,272,620,128,7421,252,1266,209,792,161
"883","19185","Wayne County, Iowa",2536,94,2111,106,1575,118,171,42,1940,108,536,89,425,64
"884","19187","Webster County, Iowa",15659,270,13779,361,10744,459,658,138,13121,372,3035,371,1880,305
"885","19189","Winnebago County, Iowa",4473,167,4069,198,3188,216,298,89,3771,183,881,136,404,88
"886","19191","Winneshiek County, Iowa",8156,198,7238,269,6240,271,440,99,6798,257,998,144,918,171
"887","19193","Woodbury County, Iowa",39826,463,36248,595,28772,724,1561,235,34687,574,7476,518,3578,411
"888","19195","Worth County, Iowa",3164,102,2735,123,2238,115,151,44,2584,126,497,80,429,95
"889","19197","Wright County, Iowa",5343,143,4490,199,3618,184,343,84,4147,202,872,133,853,139
"890","20001","Allen County, Kansas",4976,181,4376,221,3415,235,429,140,3947,263,961,158,600,138
"891","20003","Anderson County, Kansas",3164,130,2693,176,2019,195,233,94,2460,184,674,159,471,141
"892","20005","Atchison County, Kansas",5874,260,5146,273,4190,282,352,115,4794,285,956,194,728,191
"893","20007","Barber County, Kansas",1808,134,1672,135,1270,121,112,36,1560,138,402,104,136,52
"894","20009","Barton County, Kansas",10147,364,9186,385,6864,401,540,145,8646,408,2322,387,961,159
"895","20011","Bourbon County, Kansas",5773,179,5066,223,3909,273,330,102,4736,219,1157,228,707,133
"896","20013","Brown County, Kansas",3678,159,3220,185,2487,181,238,58,2982,189,733,133,458,128
"897","20015","Butler County, Kansas",24620,442,23032,549,20042,543,927,211,22105,520,2990,389,1588,302
"898","20017","Chase County, Kansas",1063,70,929,74,744,67,71,23,858,78,185,54,134,42
"899","20019","Chautauqua County, Kansas",1294,97,1098,103,802,88,104,36,994,103,296,72,196,48
"900","20021","Cherokee County, Kansas",7543,235,6745,265,4890,320,587,198,6158,283,1855,243,798,149
"901","20023","Cheyenne County, Kansas",1229,75,1150,78,900,86,98,45,1052,84,250,61,79,33
"902","20025","Clark County, Kansas",844,66,778,65,642,63,63,31,715,63,136,38,66,21
"903","20027","Clay County, Kansas",3605,134,2947,196,2418,214,161,63,2786,205,529,155,658,169
"904","20029","Cloud County, Kansas",3633,145,3289,151,2661,170,295,73,2994,157,628,132,344,105
"905","20031","Coffey County, Kansas",3492,126,3227,138,2573,163,155,48,3072,129,654,124,265,58
"906","20033","Comanche County, Kansas",844,78,725,78,529,80,18,14,707,80,196,48,119,41
"907","20035","Cowley County, Kansas",13017,388,11726,411,9292,405,734,118,10992,417,2434,312,1291,244
"908","20037","Crawford County, Kansas",15512,375,14129,360,11393,515,666,115,13463,380,2736,387,1383,228
"909","20039","Decatur County, Kansas",1304,78,1207,85,944,76,128,53,1079,92,263,68,97,41
"910","20041","Dickinson County, Kansas",7719,240,6988,242,5694,312,399,120,6589,258,1294,237,731,163
"911","20043","Doniphan County, Kansas",2785,119,2429,126,1839,140,218,50,2211,135,590,116,356,61
"912","20045","Douglas County, Kansas",49259,438,47744,545,43225,798,1477,288,46267,595,4519,618,1515,292
"913","20047","Edwards County, Kansas",1251,70,1128,70,843,70,70,27,1058,70,285,55,123,38
"914","20049","Elk County, Kansas",1005,72,819,77,699,67,89,31,730,81,120,34,186,50
"915","20051","Ellis County, Kansas",11899,302,11134,378,9697,460,432,166,10702,403,1437,273,765,217
"916","20053","Ellsworth County, Kansas",2310,174,2122,177,1671,153,152,48,1970,179,451,91,188,56
"917","20055","Finney County, Kansas",12924,285,11777,395,8294,403,441,129,11336,420,3483,398,1147,276
"918","20057","Ford County, Kansas",11571,195,10471,254,7336,344,507,176,9964,256,3135,351,1100,207
"919","20059","Franklin County, Kansas",10018,268,9071,330,6940,365,389,119,8682,345,2131,285,947,185
"920","20061","Geary County, Kansas",13429,440,12765,479,11221,495,473,135,12292,487,1544,321,664,183
"921","20063","Gove County, Kansas",1206,93,1071,86,887,83,119,30,952,85,184,58,135,33
"922","20065","Graham County, Kansas",1182,79,1070,85,910,95,119,48,951,86,160,46,112,32
"923","20067","Grant County, Kansas",2471,155,2309,192,1685,224,63,59,2246,198,624,217,162,98
"924","20069","Gray County, Kansas",2054,73,1918,78,1618,98,105,42,1813,83,300,71,136,43
"925","20071","Greeley County, Kansas",543,67,495,67,405,67,13,10,482,65,90,34,48,21
"926","20073","Greenwood County, Kansas",2537,140,2137,136,1652,135,179,47,1958,139,485,92,400,91
"927","20075","Hamilton County, Kansas",778,100,664,106,479,93,22,12,642,105,185,64,114,48
"928","20077","Harper County, Kansas",2204,103,1956,111,1453,107,154,37,1802,118,503,89,248,57
"929","20079","Harvey County, Kansas",13263,310,12464,322,10304,457,657,171,11807,343,2160,399,799,167
"930","20081","Haskell County, Kansas",1333,63,1288,65,976,86,32,21,1256,67,312,71,45,25
"931","20083","Hodgeman County, Kansas",725,73,624,60,529,65,73,28,551,59,95,31,101,50
"932","20085","Jackson County, Kansas",5204,145,4749,142,3731,161,391,122,4358,181,1018,118,455,125
"933","20087","Jefferson County, Kansas",7262,141,6679,178,5641,228,300,80,6379,193,1038,150,583,141
"934","20089","Jewell County, Kansas",1240,79,1013,82,831,84,94,34,919,79,182,42,227,61
"935","20091","Johnson County, Kansas",237949,1006,230551,1237,213316,1672,7171,641,223380,1184,17235,1170,7398,691
"936","20093","Kearny County, Kansas",1306,84,1214,93,978,110,44,26,1170,90,236,87,92,51
"937","20095","Kingman County, Kansas",3177,118,2766,170,2161,147,222,84,2544,188,605,122,411,115
"938","20097","Kiowa County, Kansas",926,55,800,52,670,57,38,18,762,51,130,34,126,34
"939","20099","Labette County, Kansas",7857,250,7101,236,5619,269,478,121,6623,250,1482,216,756,109
"940","20101","Lane County, Kansas",659,77,589,77,516,76,37,23,552,77,73,33,70,28
"941","20103","Leavenworth County, Kansas",28664,473,26966,534,23492,614,895,174,26071,533,3474,440,1698,309
"942","20105","Lincoln County, Kansas",1212,74,1030,89,809,85,56,22,974,90,221,58,182,56
"943","20107","Linn County, Kansas",4089,195,3666,209,2750,236,256,84,3410,209,916,184,423,92
"944","20109","Logan County, Kansas",1156,66,1059,73,789,85,53,25,1006,76,270,73,97,30
"945","20111","Lyon County, Kansas",13215,323,12242,364,9613,449,559,164,11683,388,2629,338,973,228
"946","20113","McPherson County, Kansas",12180,240,11266,293,9455,352,585,166,10681,328,1811,264,914,194
"947","20115","Marion County, Kansas",4617,170,4028,184,3321,160,267,52,3761,183,707,124,589,109
"948","20117","Marshall County, Kansas",4070,142,3557,167,2813,167,214,69,3343,170,744,138,513,105
"949","20119","Meade County, Kansas",1632,82,1530,82,1249,91,88,51,1442,88,281,69,102,41
"950","20121","Miami County, Kansas",12921,248,11963,377,10212,388,411,161,11552,384,1751,305,958,267
"951","20123","Mitchell County, Kansas",2445,141,2266,146,1943,144,103,50,2163,154,323,100,179,68
"952","20125","Montgomery County, Kansas",12793,336,11355,370,8756,454,799,192,10556,364,2599,327,1438,239
"953","20127","Morris County, Kansas",2294,131,2048,139,1692,131,169,55,1879,135,356,92,246,74
"954","20129","Morton County, Kansas",938,96,888,99,639,79,27,18,861,98,249,83,50,34
"955","20131","Nemaha County, Kansas",3971,116,3466,133,2957,137,196,60,3270,144,509,101,505,113
"956","20133","Neosho County, Kansas",6232,204,5395,234,4298,244,293,88,5102,250,1097,207,837,154
"957","20135","Ness County, Kansas",1156,69,982,79,836,74,59,20,923,84,146,35,174,46
"958","20137","Norton County, Kansas",1816,157,1677,143,1311,147,114,66,1563,145,366,120,139,70
"959","20139","Osage County, Kansas",6325,178,5789,187,4432,194,451,104,5338,211,1357,144,536,95
"960","20141","Osborne County, Kansas",1592,66,1326,77,1093,84,84,23,1242,78,233,63,266,55
"961","20143","Ottawa County, Kansas",2356,98,2098,111,1773,111,148,38,1950,108,325,84,258,67
"962","20145","Pawnee County, Kansas",2364,174,2171,180,1724,157,122,63,2049,181,447,121,193,90
"963","20147","Phillips County, Kansas",2203,115,2020,117,1582,109,147,42,1873,112,438,90,183,56
"964","20149","Pottawatomie County, Kansas",8788,277,8366,273,7163,323,577,119,7789,268,1203,243,422,119
"965","20151","Pratt County, Kansas",3671,191,3483,201,2720,187,122,54,3361,218,763,169,188,60
"966","20153","Rawlins County, Kansas",1170,62,1095,62,918,68,80,30,1015,68,177,48,75,29
"967","20155","Reno County, Kansas",25023,456,23044,551,18893,597,1424,276,21620,565,4151,448,1979,349
"968","20157","Republic County, Kansas",2077,107,1679,122,1349,113,143,44,1536,121,330,65,398,61
"969","20159","Rice County, Kansas",3766,142,3308,156,2682,153,217,63,3091,148,626,115,458,100
"970","20161","Riley County, Kansas",26566,609,25747,645,23343,770,752,192,24995,670,2404,470,819,233
"971","20163","Rooks County, Kansas",2106,99,1840,104,1583,112,79,27,1761,103,257,63,266,54
"972","20165","Rush County, Kansas",1318,90,1204,89,1032,87,60,21,1144,87,172,40,114,38
"973","20167","Russell County, Kansas",2930,172,2675,196,2092,213,111,66,2564,196,583,152,255,108
"974","20169","Saline County, Kansas",22048,388,20117,430,16305,607,1029,212,19088,444,3812,482,1931,298
"975","20171","Scott County, Kansas",2121,126,1914,160,1571,170,180,114,1734,172,343,127,207,147
"976","20173","Sedgwick County, Kansas",200871,1317,189149,1574,155400,2070,8277,786,180872,1726,33749,1651,11722,906
"977","20175","Seward County, Kansas",7249,243,6609,321,4439,362,181,101,6428,313,2170,301,640,209
"978","20177","Shawnee County, Kansas",74014,666,67133,849,56778,981,3843,514,63290,915,10355,694,6881,649
"979","20179","Sheridan County, Kansas",1004,60,922,70,819,66,47,20,875,73,103,31,82,31
"980","20181","Sherman County, Kansas",2239,222,2104,205,1682,191,122,75,1982,219,422,159,135,76
"981","20183","Smith County, Kansas",1525,79,1389,89,1132,87,167,40,1222,87,257,60,136,47
"982","20185","Stafford County, Kansas",1571,87,1359,92,1083,91,64,28,1295,93,276,58,212,54
"983","20187","Stanton County, Kansas",834,91,738,81,568,85,2,5,736,80,170,74,96,62
"984","20189","Stevens County, Kansas",1765,118,1658,119,1127,144,93,48,1565,117,531,147,107,43
"985","20191","Sumner County, Kansas",8955,205,8081,268,6601,279,447,104,7634,279,1480,225,874,168
"986","20193","Thomas County, Kansas",3166,182,2940,203,2392,213,131,63,2809,197,548,149,226,95
"987","20195","Trego County, Kansas",1304,90,1221,95,966,83,37,27,1184,93,255,80,83,36
"988","20197","Wabaunsee County, Kansas",2537,144,2147,172,1835,176,167,64,1980,176,312,65,390,112
"989","20199","Wallace County, Kansas",662,68,605,68,486,53,22,17,583,68,119,47,57,29
"990","20201","Washington County, Kansas",2274,112,1860,98,1473,104,265,44,1595,99,387,73,414,71
"991","20203","Wichita County, Kansas",897,83,835,81,533,87,16,11,819,83,302,80,62,34
"992","20205","Wilson County, Kansas",3461,141,3176,141,2231,155,170,57,3006,148,945,138,285,72
"993","20207","Woodson County, Kansas",1237,73,1054,88,772,74,95,42,959,88,282,53,183,57
"994","20209","Wyandotte County, Kansas",60882,646,55716,780,41604,1023,2872,410,52844,785,14112,787,5166,432
"995","21001","Adair County, Kentucky",6890,228,5937,268,4615,307,405,138,5532,306,1322,209,953,188
"996","21003","Allen County, Kentucky",7629,276,6665,321,4777,321,318,121,6347,323,1888,263,964,224
"997","21005","Anderson County, Kentucky",9063,267,8360,301,6771,375,417,166,7943,344,1589,294,703,168
"998","21007","Ballard County, Kentucky",2945,150,2629,155,2231,156,121,56,2508,163,398,99,316,79
"999","21009","Barren County, Kentucky",17307,377,15245,442,11424,510,952,229,14293,480,3821,451,2062,289
"1000","21011","Bath County, Kentucky",4756,222,4144,226,2979,245,344,98,3800,225,1165,213,612,134
"1001","21013","Bell County, Kentucky",9483,270,7588,396,5055,415,504,116,7084,397,2533,372,1895,318
"1002","21015","Boone County, Kentucky",48683,483,46499,575,40981,784,1724,308,44775,627,5518,763,2184,340
"1003","21017","Bourbon County, Kentucky",8135,259,7340,313,5331,357,308,134,7032,318,2009,315,795,189
"1004","21019","Boyd County, Kentucky",18281,475,16556,463,12756,565,941,257,15615,551,3800,525,1725,240
"1005","21021","Boyle County, Kentucky",11612,280,10346,345,8203,351,357,78,9989,341,2143,294,1266,209
"1006","21023","Bracken County, Kentucky",3124,168,2839,187,2172,197,182,66,2657,201,667,122,285,86
"1007","21025","Breathitt County, Kentucky",5506,162,4427,211,3077,206,362,92,4065,221,1350,188,1079,141
"1008","21027","Breckinridge County, Kentucky",7532,249,6288,276,4828,286,329,92,5959,285,1460,250,1244,194
"1009","21029","Bullitt County, Kentucky",30485,331,28363,495,22868,654,1105,198,27258,523,5495,480,2122,354
"1010","21031","Butler County, Kentucky",4403,171,3695,202,2612,196,141,86,3554,226,1083,176,708,154
"1011","21033","Caldwell County, Kentucky",5259,218,4693,230,3199,284,197,88,4496,237,1494,239,566,136
"1012","21035","Calloway County, Kentucky",14621,471,13510,462,11459,518,805,203,12705,504,2051,303,1111,217
"1013","21037","Campbell County, Kentucky",38030,474,35387,549,30618,703,1482,272,33905,585,4769,462,2643,350
"1014","21039","Carlisle County, Kentucky",1795,102,1632,95,1352,101,26,16,1606,97,280,68,163,55
"1015","21041","Carroll County, Kentucky",4141,181,3471,224,2435,252,178,77,3293,230,1036,214,670,142
"1016","21043","Carter County, Kentucky",9483,334,7335,370,5701,346,614,202,6721,415,1634,209,2148,270
"1017","21045","Casey County, Kentucky",5856,279,4800,300,3403,337,369,131,4431,300,1397,252,1056,195
"1018","21047","Christian County, Kentucky",25552,446,22830,537,17977,635,643,117,22187,533,4853,502,2722,380
"1019","21049","Clark County, Kentucky",14836,249,13586,335,10826,455,402,111,13184,334,2760,379,1250,217
"1020","21051","Clay County, Kentucky",7015,288,5637,370,3946,355,424,140,5213,366,1691,262,1378,286
"1021","21053","Clinton County, Kentucky",3791,179,2761,215,1943,229,231,90,2530,227,818,160,1030,201
"1022","21055","Crittenden County, Kentucky",3452,161,2895,193,2013,193,221,83,2674,186,882,181,557,125
"1023","21057","Cumberland County, Kentucky",2451,187,2033,181,1407,164,115,65,1918,181,626,133,418,133
"1024","21059","Daviess County, Kentucky",40603,461,36928,599,28862,788,1500,215,35428,612,8066,650,3675,464
"1025","21061","Edmonson County, Kentucky",4847,196,4256,203,2982,282,269,100,3987,210,1274,242,591,162
"1026","21063","Elliott County, Kentucky",2173,216,1681,221,1220,179,115,66,1566,230,461,178,492,137
"1027","21065","Estill County, Kentucky",5598,220,4475,258,3108,260,302,103,4173,282,1367,253,1123,169
"1028","21067","Fayette County, Kentucky",134229,1000,128082,993,109083,1223,3416,417,124666,1125,18999,1142,6147,578
"1029","21069","Fleming County, Kentucky",5713,203,4801,291,3668,246,254,100,4547,294,1133,205,912,203
"1030","21071","Floyd County, Kentucky",14040,352,12038,430,8929,487,778,200,11260,459,3109,478,2002,299
"1031","21073","Franklin County, Kentucky",22247,405,20584,431,16192,610,887,204,19697,494,4392,543,1663,304
"1032","21075","Fulton County, Kentucky",2315,162,2023,177,1448,179,141,59,1882,176,575,127,292,82
"1033","21077","Gallatin County, Kentucky",3004,199,2640,184,1976,179,135,67,2505,176,664,124,364,102
"1034","21079","Garrard County, Kentucky",6554,172,5870,190,4532,270,221,85,5649,234,1338,236,684,164
"1035","21081","Grant County, Kentucky",9044,243,8302,277,5885,395,344,144,7958,292,2417,390,742,197
"1036","21083","Graves County, Kentucky",14214,361,12568,416,10035,382,694,165,11874,435,2533,328,1646,238
"1037","21085","Grayson County, Kentucky",9398,290,7838,386,5623,340,577,149,7261,388,2215,301,1560,247
"1038","21087","Green County, Kentucky",4390,151,3566,207,2583,219,342,99,3224,199,983,173,824,165
"1039","21089","Greenup County, Kentucky",14182,259,12502,352,10103,446,569,116,11933,372,2399,349,1680,266
"1040","21091","Hancock County, Kentucky",3449,104,3114,140,2266,158,128,53,2986,148,848,122,335,95
"1041","21093","Hardin County, Kentucky",42288,708,39063,768,31639,703,1592,285,37471,743,7424,710,3225,400
"1042","21095","Harlan County, Kentucky",10370,299,8571,353,6219,361,603,144,7968,368,2352,288,1799,251
"1043","21097","Harrison County, Kentucky",7264,213,6146,282,4559,330,261,82,5885,280,1587,272,1118,257
"1044","21099","Hart County, Kentucky",7064,231,5810,254,4259,275,353,124,5457,271,1551,279,1254,178
"1045","21101","Henderson County, Kentucky",18194,354,16165,412,11883,504,612,149,15553,440,4282,478,2029,264
"1046","21103","Henry County, Kentucky",5967,132,5189,208,3666,260,232,79,4957,224,1523,219,778,169
"1047","21105","Hickman County, Kentucky",1674,165,1443,175,1152,160,85,49,1358,184,291,100,231,87
"1048","21107","Hopkins County, Kentucky",18314,353,16442,433,12191,459,957,211,15485,445,4251,330,1872,284
"1049","21109","Jackson County, Kentucky",4956,212,4106,287,3035,264,179,88,3927,291,1071,254,850,214
"1050","21111","Jefferson County, Kentucky",323293,1353,299232,1671,244272,2213,11257,694,287975,1765,54960,1989,24061,1119
"1051","21113","Jessamine County, Kentucky",19054,325,17404,509,14793,547,635,185,16769,517,2611,430,1650,387
"1052","21115","Johnson County, Kentucky",8376,377,7260,435,5906,442,351,111,6909,456,1354,270,1116,237
"1053","21117","Kenton County, Kentucky",66999,579,62781,701,52997,969,2427,289,60354,676,9784,696,4218,398
"1054","21119","Knott County, Kentucky",5458,286,4530,324,3484,326,360,134,4170,338,1046,192,928,171
"1055","21121","Knox County, Kentucky",11115,327,8634,342,6203,447,606,182,8028,378,2431,408,2481,337
"1056","21123","Larue County, Kentucky",5906,174,5009,265,3878,283,254,97,4755,259,1131,249,897,218
"1057","21125","Laurel County, Kentucky",23146,425,20108,542,15519,643,1061,226,19047,528,4589,515,3038,408
"1058","21127","Lawrence County, Kentucky",5524,274,4324,320,3452,320,367,112,3957,304,872,210,1200,218
"1059","21129","Lee County, Kentucky",2616,147,2054,159,1351,206,106,56,1948,154,703,167,562,121
"1060","21131","Leslie County, Kentucky",3688,236,3125,218,2440,234,157,99,2968,214,685,163,563,147
"1061","21133","Letcher County, Kentucky",8406,271,7012,335,5380,371,314,122,6698,316,1632,244,1394,235
"1062","21135","Lewis County, Kentucky",4737,212,3910,263,2884,269,321,95,3589,266,1026,199,827,153
"1063","21137","Lincoln County, Kentucky",9543,262,8182,339,5884,383,253,76,7929,342,2298,278,1361,218
"1064","21139","Livingston County, Kentucky",3560,201,3071,235,2402,257,267,108,2804,238,669,190,489,129
"1065","21141","Logan County, Kentucky",10749,338,8857,397,7393,412,846,203,8011,399,1464,220,1892,294
"1066","21143","Lyon County, Kentucky",3207,277,2761,287,2075,232,68,35,2693,289,686,156,446,139
"1067","21145","McCracken County, Kentucky",27062,578,25335,604,21504,599,984,213,24351,669,3831,422,1727,262
"1068","21147","McCreary County, Kentucky",5700,269,4631,335,3302,372,382,167,4249,358,1329,257,1069,311
"1069","21149","McLean County, Kentucky",3659,153,3240,148,2537,186,140,63,3100,169,703,140,419,105
"1070","21151","Madison County, Kentucky",35411,620,32947,688,27189,779,1121,201,31826,682,5758,633,2464,373
"1071","21153","Magoffin County, Kentucky",4525,244,3673,271,2816,226,264,105,3409,249,857,171,852,168
"1072","21155","Marion County, Kentucky",7536,190,6429,247,4425,300,427,127,6002,257,2004,292,1107,204
"1073","21157","Marshall County, Kentucky",13217,489,12114,497,9922,555,699,236,11415,523,2192,380,1103,245
"1074","21159","Martin County, Kentucky",3637,293,2957,304,2217,331,122,49,2835,309,740,198,680,182
"1075","21161","Mason County, Kentucky",6591,251,5663,326,4571,294,254,106,5409,317,1092,206,928,208
"1076","21163","Meade County, Kentucky",10331,331,9589,354,7641,401,358,128,9231,376,1948,296,742,161
"1077","21165","Menifee County, Kentucky",2130,163,1664,170,1291,157,122,55,1542,164,373,101,466,111
"1078","21167","Mercer County, Kentucky",8909,244,7660,308,6079,423,374,97,7286,324,1581,324,1249,238
"1079","21169","Metcalfe County, Kentucky",4087,178,3522,198,2583,201,255,100,3267,217,939,159,565,155
"1080","21171","Monroe County, Kentucky",4491,132,3692,174,2533,213,208,76,3484,180,1159,145,799,155
"1081","21173","Montgomery County, Kentucky",10748,324,9783,366,6800,459,478,141,9305,373,2983,478,965,212
"1082","21175","Morgan County, Kentucky",4463,187,3561,204,2910,215,254,94,3307,212,651,123,902,144
"1083","21177","Muhlenberg County, Kentucky",11456,344,9965,368,7653,449,494,150,9471,348,2312,317,1491,241
"1084","21179","Nelson County, Kentucky",18163,288,16834,356,13148,504,576,163,16258,395,3686,399,1329,229
"1085","21181","Nicholas County, Kentucky",2730,145,2279,172,1436,173,104,60,2175,174,843,154,451,124
"1086","21183","Ohio County, Kentucky",8845,269,7494,322,5164,389,200,79,7294,337,2330,330,1351,273
"1087","21185","Oldham County, Kentucky",21934,270,21214,295,19342,382,542,163,20672,301,1872,285,720,156
"1088","21187","Owen County, Kentucky",4167,211,3416,215,2657,229,181,84,3235,218,759,184,751,176
"1089","21189","Owsley County, Kentucky",1460,152,1007,143,745,141,107,53,900,143,262,88,453,110
"1090","21191","Pendleton County, Kentucky",5194,231,4498,288,3325,314,155,73,4343,281,1173,208,696,188
"1091","21193","Perry County, Kentucky",11252,352,9749,334,7219,441,421,184,9328,382,2530,405,1503,275
"1092","21195","Pike County, Kentucky",23855,437,20527,587,15986,619,1439,265,19088,609,4541,417,3328,504
"1093","21197","Powell County, Kentucky",4665,238,3875,242,2857,246,216,105,3659,255,1018,192,790,198
"1094","21199","Pulaski County, Kentucky",25255,468,22121,532,17149,625,1204,234,20917,606,4972,503,3134,354
"1095","21201","Robertson County, Kentucky",844,82,677,81,468,90,48,32,629,76,209,68,167,61
"1096","21203","Rockcastle County, Kentucky",6307,232,5218,275,3805,267,252,82,4966,278,1413,230,1089,163
"1097","21205","Rowan County, Kentucky",8819,618,7981,609,6450,629,349,134,7632,618,1531,357,838,184
"1098","21207","Russell County, Kentucky",6982,259,5875,285,4521,305,411,126,5464,303,1354,208,1107,209
"1099","21209","Scott County, Kentucky",21347,248,20158,251,16396,393,407,129,19751,272,3762,458,1189,185
"1100","21211","Shelby County, Kentucky",17046,353,15992,406,12864,491,519,123,15473,394,3128,460,1054,205
"1101","21213","Simpson County, Kentucky",7222,285,6313,328,4958,346,361,168,5952,353,1355,237,909,235
"1102","21215","Spencer County, Kentucky",6892,181,6596,177,5388,280,189,82,6407,184,1208,235,296,98
"1103","21217","Taylor County, Kentucky",9771,316,8742,366,6806,376,570,193,8172,370,1936,374,1029,240
"1104","21219","Todd County, Kentucky",4355,169,3306,215,2506,227,256,118,3050,209,800,195,1049,185
"1105","21221","Trigg County, Kentucky",5755,248,5039,275,4096,274,219,89,4820,299,943,214,716,168
"1106","21223","Trimble County, Kentucky",3238,155,2785,192,2029,234,121,70,2664,193,756,182,453,124
"1107","21225","Union County, Kentucky",4934,234,4457,251,3094,245,167,70,4290,255,1363,223,477,121
"1108","21227","Warren County, Kentucky",51010,703,47739,857,38957,1168,1367,270,46372,886,8782,840,3271,462
"1109","21229","Washington County, Kentucky",4642,177,4016,186,2956,208,216,116,3800,218,1060,174,626,118
"1110","21231","Wayne County, Kentucky",7856,285,6170,370,4616,388,360,134,5810,379,1554,332,1686,289
"1111","21233","Webster County, Kentucky",4759,172,3935,204,2742,244,128,51,3807,206,1193,225,824,137
"1112","21235","Whitley County, Kentucky",12774,422,10787,511,7766,588,486,171,10301,522,3021,470,1987,349
"1113","21237","Wolfe County, Kentucky",2470,138,1768,198,1167,176,197,118,1571,222,601,167,702,140
"1114","21239","Woodford County, Kentucky",10395,214,9669,273,8528,291,342,107,9327,275,1141,201,726,162
"1115","22001","Acadia Parish, Louisiana",21555,464,18942,587,12870,630,529,174,18413,590,6072,622,2613,415
"1116","22003","Allen Parish, Louisiana",7687,887,7062,860,4455,535,251,120,6811,845,2607,496,625,173
"1117","22005","Ascension Parish, Louisiana",45195,582,42905,643,36099,922,996,247,41909,716,6806,842,2290,381
"1118","22007","Assumption Parish, Louisiana",8289,283,6810,344,4816,417,129,67,6681,364,1994,357,1479,278
"1119","22009","Avoyelles Parish, Louisiana",14446,517,12253,541,8183,605,601,254,11652,566,4070,444,2193,300
"1120","22011","Beauregard Parish, Louisiana",13352,382,12555,367,9879,364,569,138,11986,386,2676,331,797,148
"1121","22013","Bienville Parish, Louisiana",5236,230,4271,220,2577,180,190,65,4081,232,1694,175,965,157
"1122","22015","Bossier Parish, Louisiana",47849,775,44272,898,35608,1027,1601,311,42671,941,8664,775,3577,536
"1123","22017","Caddo Parish, Louisiana",94311,1097,83253,1323,60635,1395,3234,360,80019,1341,22618,1317,11058,912
"1124","22019","Calcasieu Parish, Louisiana",76829,1082,69284,1252,54129,1594,2718,467,66566,1250,15155,1322,7545,847
"1125","22021","Caldwell Parish, Louisiana",3468,286,2681,284,2078,281,115,66,2566,266,603,156,787,194
"1126","22023","Cameron Parish, Louisiana",2216,186,1925,209,1677,227,37,29,1888,212,248,81,291,129
"1127","22025","Catahoula Parish, Louisiana",3055,190,2534,201,1621,194,122,68,2412,206,913,181,521,125
"1128","22027","Claiborne Parish, Louisiana",5042,321,3833,285,2143,198,105,52,3728,290,1690,232,1209,152
"1129","22029","Concordia Parish, Louisiana",6273,386,5300,453,3398,448,563,159,4737,428,1902,315,973,241
"1130","22031","De Soto Parish, Louisiana",10168,279,9019,306,6313,387,262,95,8757,318,2706,369,1149,237
"1131","22033","East Baton Rouge Parish, Louisiana",171349,1625,159038,1746,128496,2019,4071,477,154967,1728,30542,1481,12311,923
"1132","22035","East Carroll Parish, Louisiana",2213,379,1485,302,997,240,36,41,1449,294,488,148,728,218
"1133","22037","East Feliciana Parish, Louisiana",6520,357,5505,384,4019,346,217,92,5288,385,1486,273,1015,226
"1134","22039","Evangeline Parish, Louisiana",12076,402,9995,439,6164,484,258,123,9737,464,3831,470,2081,283
"1135","22041","Franklin Parish, Louisiana",7279,316,5731,377,3881,336,206,80,5525,370,1850,262,1548,267
"1136","22043","Grant Parish, Louisiana",6577,286,5623,321,4078,364,273,100,5350,326,1545,270,954,215
"1137","22045","Iberia Parish, Louisiana",26697,596,23537,646,15579,795,651,180,22886,644,7958,696,3160,440
"1138","22047","Iberville Parish, Louisiana",10933,409,9867,426,7286,525,347,117,9520,436,2581,433,1066,229
"1139","22049","Jackson Parish, Louisiana",5364,305,4364,322,2960,304,165,61,4199,326,1404,236,1000,161
"1140","22051","Jefferson Parish, Louisiana",174954,1046,159674,1341,126197,1709,6323,678,153351,1570,33477,1292,15280,1052
"1141","22053","Jefferson Davis Parish, Louisiana",11351,385,9590,437,6709,386,578,167,9012,451,2881,316,1761,291
"1142","22055","Lafayette Parish, Louisiana",95607,1035,87896,1304,71418,1513,2485,593,85411,1412,16478,1137,7711,883
"1143","22057","Lafourche Parish, Louisiana",36412,530,31861,627,24508,717,869,232,30992,635,7353,614,4551,503
"1144","22059","LaSalle Parish, Louisiana",4533,260,4045,288,2998,321,194,122,3851,314,1047,231,488,140
"1145","22061","Lincoln Parish, Louisiana",17729,388,16441,471,12300,575,546,172,15895,495,4141,414,1288,260
"1146","22063","Livingston Parish, Louisiana",48474,921,46068,991,37218,1308,1169,263,44899,1035,8850,1004,2406,505
"1147","22065","Madison Parish, Louisiana",3076,209,2467,193,1536,158,104,53,2363,196,931,143,609,140
"1148","22067","Morehouse Parish, Louisiana",9240,311,6646,322,4695,405,470,186,6176,300,1951,296,2594,325
"1149","22069","Natchitoches Parish, Louisiana",13765,512,10520,513,7872,499,864,217,9656,513,2648,346,3245,360
"1150","22071","Orleans Parish, Louisiana",156586,1132,140352,1393,108585,1778,4410,405,135942,1401,31767,1376,16234,925
"1151","22073","Ouachita Parish, Louisiana",58493,689,50087,768,38467,1076,1899,317,48188,752,11620,843,8406,635
"1152","22075","Plaquemines Parish, Louisiana",8039,240,7396,276,5957,332,251,103,7145,299,1439,274,643,149
"1153","22077","Pointe Coupee Parish, Louisiana",8287,269,6817,348,4833,381,255,107,6562,360,1984,355,1470,277
"1154","22079","Rapides Parish, Louisiana",48651,664,43526,752,32300,924,1954,366,41572,810,11226,791,5125,528
"1155","22081","Red River Parish, Louisiana",2800,197,2338,199,1717,190,201,96,2137,206,621,169,462,115
"1156","22083","Richland Parish, Louisiana",7202,280,6015,312,3482,324,113,45,5902,312,2533,274,1187,222
"1157","22085","Sabine Parish, Louisiana",8361,308,6402,301,4526,326,366,73,6036,287,1876,227,1959,228
"1158","22087","St. Bernard Parish, Louisiana",15472,248,13829,337,10455,401,437,114,13392,367,3374,382,1643,236
"1159","22089","St. Charles Parish, Louisiana",18640,368,17261,425,14315,539,428,123,16833,446,2946,483,1379,276
"1160","22091","St. Helena Parish, Louisiana",3991,229,3126,303,2287,248,108,74,3018,311,839,213,865,273
"1161","22093","St. James Parish, Louisiana",7464,226,6440,258,5010,317,306,101,6134,265,1430,280,1024,223
"1162","22095","St. John the Baptist Parish, Louisiana",15109,354,13681,454,10951,468,555,184,13126,489,2730,399,1428,275
"1163","22097","St. Landry Parish, Louisiana",30479,527,24633,652,17023,735,1099,204,23534,689,7610,606,5846,525
"1164","22099","St. Martin Parish, Louisiana",19537,476,16556,527,11856,688,664,215,15892,502,4700,590,2981,398
"1165","22101","St. Mary Parish, Louisiana",18565,476,15433,523,9606,534,551,151,14882,530,5827,492,3132,366
"1166","22103","St. Tammany Parish, Louisiana",99293,800,94172,1027,82314,1290,2549,344,91623,1041,11858,999,5121,644
"1167","22105","Tangipahoa Parish, Louisiana",48390,852,44083,999,33545,1281,1331,286,42752,1021,10538,1103,4307,612
"1168","22107","Tensas Parish, Louisiana",1502,132,1139,132,716,92,67,43,1072,131,423,107,363,103
"1169","22109","Terrebonne Parish, Louisiana",41960,649,37721,785,29402,1008,1227,347,36494,848,8319,786,4239,544
"1170","22111","Union Parish, Louisiana",7669,294,5804,304,4038,316,376,136,5428,317,1766,296,1865,276
"1171","22113","Vermilion Parish, Louisiana",21580,471,19667,531,14747,625,746,172,18921,532,4920,511,1913,296
"1172","22115","Vernon Parish, Louisiana",17263,567,15878,553,12321,527,494,111,15384,564,3557,307,1385,217
"1173","22117","Washington Parish, Louisiana",17367,489,14580,611,9308,690,679,213,13901,613,5272,514,2787,437
"1174","22119","Webster Parish, Louisiana",14831,355,12362,462,7343,465,412,115,11950,442,5019,427,2469,329
"1175","22121","West Baton Rouge Parish, Louisiana",9759,310,9101,332,7215,406,251,99,8850,332,1886,340,658,191
"1176","22123","West Carroll Parish, Louisiana",3700,181,2927,214,1873,219,160,72,2767,205,1054,185,773,171
"1177","22125","West Feliciana Parish, Louisiana",3852,222,3620,241,2664,275,32,37,3588,227,956,233,232,121
"1178","22127","Winn Parish, Louisiana",4726,279,3784,309,2489,281,140,70,3644,309,1295,201,942,179
"1179","23001","Androscoggin County, Maine",45770,543,41719,648,35703,633,2930,382,38789,717,6016,461,4051,468
"1180","23003","Aroostook County, Maine",28939,415,24958,496,20331,516,2626,313,22332,527,4627,419,3981,342
"1181","23005","Cumberland County, Maine",125986,942,118530,1160,107997,1313,5803,536,112727,1126,10533,799,7456,720
"1182","23007","Franklin County, Maine",12018,371,10808,442,8933,443,815,168,9993,458,1875,290,1210,272
"1183","23009","Hancock County, Maine",24103,535,22229,572,19208,560,1799,223,20430,588,3021,365,1874,303
"1184","23011","Kennebec County, Maine",52752,645,48410,789,41905,917,2995,409,45415,855,6505,543,4342,518
"1185","23013","Knox County, Maine",17529,383,16205,407,14580,429,1469,249,14736,480,1625,284,1324,237
"1186","23015","Lincoln County, Maine",15372,417,14149,448,12510,466,1308,205,12841,454,1639,319,1223,264
"1187","23017","Oxford County, Maine",22747,526,20319,575,17170,544,1902,238,18417,575,3149,375,2428,295
"1188","23019","Penobscot County, Maine",62812,749,57882,821,49178,985,4338,447,53544,898,8704,705,4930,417
"1189","23021","Piscataquis County, Maine",7176,257,6431,248,5153,272,618,132,5813,265,1278,181,745,120
"1190","23023","Sagadahoc County, Maine",15879,331,14859,379,12746,424,1085,230,13774,396,2113,407,1020,213
"1191","23025","Somerset County, Maine",21596,348,18997,421,15665,468,1748,259,17249,491,3332,379,2599,321
"1192","23027","Waldo County, Maine",17213,324,15876,356,13827,369,1289,218,14587,390,2049,215,1337,252
"1193","23029","Washington County, Maine",13258,269,11631,279,9555,272,1351,168,10280,303,2076,191,1627,185
"1194","23031","York County, Maine",87914,873,82829,1038,73245,1098,5880,684,76949,1147,9584,931,5085,642
"1195","24001","Allegany County, Maryland",27563,534,24139,548,19441,580,1868,252,22271,593,4698,528,3424,339
"1196","24003","Anne Arundel County, Maryland",218682,1219,210618,1308,194081,1653,7352,673,203266,1367,16537,1067,8064,664
"1197","24005","Baltimore County, Maryland",326932,1489,306698,1750,272699,2399,14590,830,292108,1983,33999,1580,20234,1034
"1198","24009","Calvert County, Maryland",32751,457,30946,558,28472,691,1189,228,29757,564,2474,434,1805,355
"1199","24011","Caroline County, Maryland",11963,229,10771,255,8878,278,455,105,10316,257,1893,228,1192,197
"1200","24013","Carroll County, Maryland",62907,499,58697,636,52990,819,2075,231,56622,603,5707,521,4210,462
"1201","24015","Cecil County, Maryland",38672,515,36252,551,31702,687,1726,245,34526,615,4550,477,2420,367
"1202","24017","Charles County, Maryland",58138,568,54654,737,49925,802,1687,354,52967,764,4729,522,3484,473
"1203","24019","Dorchester County, Maryland",13123,317,11701,356,9168,402,668,222,11033,400,2533,279,1422,198
"1204","24021","Frederick County, Maryland",97615,585,92991,788,85496,1072,3051,349,89940,820,7495,804,4624,411
"1205","24023","Garrett County, Maryland",12392,393,10887,414,8903,431,806,195,10081,434,1984,273,1505,212
"1206","24025","Harford County, Maryland",97468,647,93029,819,84342,1086,3115,360,89914,843,8687,715,4439,481
"1207","24027","Howard County, Maryland",118037,652,115359,850,109270,1044,3287,544,112072,985,6089,757,2678,534
"1208","24029","Kent County, Maryland",8291,221,7436,257,6102,331,487,120,6949,277,1334,260,855,167
"1209","24031","Montgomery County, Maryland",383308,1061,373804,1391,349475,1854,12840,875,360964,1563,24329,1346,9504,802
"1210","24033","Prince George's County, Maryland",337366,1287,323679,1509,280566,1915,10702,658,312977,1582,43113,1501,13687,918
"1211","24035","Queen Anne's County, Maryland",18914,269,18170,287,16038,329,613,168,17557,350,2132,308,744,164
"1212","24037","St. Mary's County, Maryland",40236,682,37767,740,34551,762,1828,387,35939,762,3216,446,2469,421
"1213","24039","Somerset County, Maryland",8113,356,7080,357,5669,393,391,122,6689,367,1411,298,1033,219
"1214","24041","Talbot County, Maryland",16251,342,15059,429,13341,478,915,243,14144,405,1718,283,1192,256
"1215","24043","Washington County, Maryland",58630,873,53297,998,43577,1017,2727,389,50570,1105,9720,848,5333,598
"1216","24045","Wicomico County, Maryland",39452,614,36299,782,30088,807,1648,312,34651,862,6211,596,3153,486
"1217","24047","Worcester County, Maryland",22573,649,20864,648,18231,652,1012,223,19852,669,2633,340,1709,244
"1218","24510","Baltimore city, Maryland",244893,1599,219593,1637,172128,2171,8198,714,211395,1705,47465,1685,25300,1097
"1219","25001","Barnstable County, Massachusetts",98163,1365,93600,1345,83895,1312,6003,614,87597,1360,9705,732,4563,457
"1220","25003","Berkshire County, Massachusetts",55525,781,50758,816,44295,917,4390,467,46368,908,6463,559,4767,471
"1221","25005","Bristol County, Massachusetts",227816,990,206829,1365,171969,1638,10191,723,196638,1377,34860,1521,20987,1213
"1222","25007","Dukes County, Massachusetts",6801,468,6463,488,5943,496,566,214,5897,438,520,192,338,137
"1223","25009","Essex County, Massachusetts",307959,1047,286315,1526,246400,1788,12819,870,273496,1710,39915,1670,21644,1156
"1224","25011","Franklin County, Massachusetts",30792,330,28204,442,24602,472,2494,324,25710,532,3602,384,2588,286
"1225","25013","Hampden County, Massachusetts",183309,895,163103,1334,131021,1751,9056,645,154047,1302,32082,1347,20206,985
"1226","25015","Hampshire County, Massachusetts",60903,669,57509,726,52411,810,4060,492,53449,878,5098,515,3394,338
"1227","25017","Middlesex County, Massachusetts",624335,1904,592854,2089,547571,2617,23208,1091,569646,2289,45283,1736,31481,1211
"1228","25019","Nantucket County, Massachusetts",4031,280,3926,276,3761,276,171,96,3755,297,165,75,105,51
"1229","25021","Norfolk County, Massachusetts",276744,928,264338,1282,242555,1786,12010,800,252328,1439,21783,1373,12406,869
"1230","25023","Plymouth County, Massachusetts",196307,1142,185801,1276,164317,1582,9120,798,176681,1264,21484,1087,10506,908
"1231","25025","Suffolk County, Massachusetts",315192,1720,293913,2010,254124,2456,9516,835,284397,2171,39789,1440,21279,1046
"1232","25027","Worcester County, Massachusetts",326571,1393,304409,1709,265817,2188,14559,1057,289850,1912,38592,1420,22162,1238
"1233","26001","Alcona County, Michigan",4795,145,4253,150,3280,150,409,67,3844,151,973,97,542,69
"1234","26003","Alger County, Michigan",3060,178,2725,181,2328,183,379,92,2346,170,397,82,335,87
"1235","26005","Allegan County, Michigan",44240,473,40828,590,34619,686,1513,271,39315,637,6209,480,3412,425
"1236","26007","Alpena County, Michigan",12584,285,11006,333,9131,334,913,139,10093,361,1875,219,1578,236
"1237","26009","Antrim County, Michigan",10108,249,9427,277,7789,255,537,96,8890,294,1638,175,681,96
"1238","26011","Arenac County, Michigan",6292,184,5350,208,4196,186,450,56,4900,208,1154,120,942,89
"1239","26013","Baraga County, Michigan",3164,157,2661,160,2218,142,316,77,2345,149,443,81,503,83
"1240","26015","Barry County, Michigan",24115,404,21713,486,18237,532,1055,185,20658,515,3476,321,2402,316
"1241","26017","Bay County, Michigan",45007,443,40546,674,33182,804,2474,402,38072,719,7364,643,4461,549
"1242","26019","Benzie County, Michigan",6817,249,6360,238,5526,227,509,115,5851,261,834,138,457,82
"1243","26021","Berrien County, Michigan",63403,668,57705,831,46574,924,2975,346,54730,813,11131,762,5698,583
"1244","26023","Branch County, Michigan",16625,350,14863,393,11425,398,802,114,14061,404,3438,312,1762,221
"1245","26025","Calhoun County, Michigan",53197,672,48233,800,38030,837,3038,306,45195,852,10203,607,4964,489
"1246","26027","Cass County, Michigan",20704,353,18788,388,15041,450,1187,172,17601,406,3747,371,1916,235
"1247","26029","Charlevoix County, Michigan",11769,261,10878,265,9005,311,564,86,10314,254,1873,203,891,149
"1248","26031","Cheboygan County, Michigan",10671,286,9408,312,7851,307,719,139,8689,332,1557,170,1263,180
"1249","26033","Chippewa County, Michigan",13757,318,12282,350,10390,377,926,133,11356,357,1892,260,1475,198
"1250","26035","Clare County, Michigan",11686,351,10063,329,7579,290,772,116,9291,339,2484,235,1623,186
"1251","26037","Clinton County, Michigan",30835,278,28864,340,25142,471,1212,158,27652,341,3722,379,1971,251
"1252","26039","Crawford County, Michigan",5705,220,5264,210,4084,184,323,70,4941,217,1180,171,441,88
"1253","26041","Delta County, Michigan",15695,331,13675,423,10929,419,1050,168,12625,406,2746,298,2020,272
"1254","26043","Dickinson County, Michigan",11394,292,10267,320,8355,403,836,212,9431,338,1912,284,1127,221
"1255","26045","Eaton County, Michigan",44895,369,42170,444,35882,697,2100,340,40070,473,6288,508,2725,279
"1256","26047","Emmet County, Michigan",14280,361,13304,367,11024,393,708,152,12596,395,2280,338,976,199
"1257","26049","Genesee County, Michigan",164905,895,149708,1193,120841,1398,7309,680,142399,1249,28867,1149,15197,915
"1258","26051","Gladwin County, Michigan",10714,279,9230,281,7222,277,796,96,8434,276,2008,170,1484,167
"1259","26053","Gogebic County, Michigan",6770,265,5676,269,4707,272,612,128,5064,287,969,161,1094,144
"1260","26055","Grand Traverse County, Michigan",38511,604,36178,682,31494,782,1503,313,34675,676,4684,506,2333,339
"1261","26057","Gratiot County, Michigan",14859,290,13278,332,10500,342,678,116,12600,327,2778,271,1581,204
"1262","26059","Hillsdale County, Michigan",17683,315,15287,315,12259,329,1186,138,14101,332,3028,242,2396,202
"1263","26061","Houghton County, Michigan",13884,281,12437,311,10629,396,796,121,11641,306,1808,196,1447,193
"1264","26063","Huron County, Michigan",13474,232,11703,254,9101,239,1006,123,10697,259,2602,199,1771,171
"1265","26065","Ingham County, Michigan",114732,860,108061,1076,92221,1256,3739,434,104322,1049,15840,869,6671,567
"1266","26067","Ionia County, Michigan",22782,398,20875,412,16260,476,873,156,20002,437,4615,421,1907,224
"1267","26069","Iosco County, Michigan",11402,329,10094,316,8004,316,874,120,9220,316,2090,233,1308,172
"1268","26071","Iron County, Michigan",5087,186,4311,169,3451,157,469,67,3842,175,860,112,776,107
"1269","26073","Isabella County, Michigan",24582,455,23080,493,19125,524,807,112,22273,497,3955,344,1502,185
"1270","26075","Jackson County, Michigan",61833,712,56701,862,45010,1034,2768,341,53933,950,11691,788,5132,517
"1271","26077","Kalamazoo County, Michigan",105299,912,99203,1126,85907,1397,3847,437,95356,1135,13296,937,6096,586
"1272","26079","Kalkaska County, Michigan",7001,212,6346,221,4950,209,471,93,5875,226,1396,171,655,113
"1273","26081","Kent County, Michigan",249821,1005,233939,1283,201879,1586,8340,755,225599,1467,32060,1474,15882,856
"1274","26083","Keweenaw County, Michigan",1039,66,958,66,825,61,82,29,876,69,133,42,81,28
"1275","26085","Lake County, Michigan",4349,168,3661,160,2557,145,259,50,3402,171,1104,106,688,89
"1276","26087","Lapeer County, Michigan",33977,426,31373,556,26279,669,1661,263,29712,562,5094,380,2604,374
"1277","26089","Leelanau County, Michigan",9108,310,8640,310,7780,310,612,150,8028,301,860,144,468,84
"1278","26091","Lenawee County, Michigan",38667,513,35780,569,29126,669,1969,286,33811,600,6654,453,2887,311
"1279","26093","Livingston County, Michigan",73924,481,70947,545,63535,741,2927,302,68020,571,7412,586,2977,355
"1280","26095","Luce County, Michigan",2128,165,1829,148,1521,144,143,49,1686,141,308,71,299,79
"1281","26097","Mackinac County, Michigan",5063,199,4571,207,3531,169,324,71,4247,219,1040,117,492,89
"1282","26099","Macomb County, Michigan",351715,1005,328887,1343,277695,2049,15514,989,313373,1394,51192,1691,22828,909
"1283","26101","Manistee County, Michigan",9681,320,8524,338,7225,296,648,115,7876,336,1299,170,1157,166
"1284","26103","Marquette County, Michigan",26709,454,24329,516,21133,511,1536,220,22793,544,3196,288,2380,279
"1285","26105","Mason County, Michigan",12135,314,10969,330,8735,313,618,110,10351,337,2234,242,1166,184
"1286","26107","Mecosta County, Michigan",15800,310,14307,360,11480,414,941,167,13366,387,2827,274,1493,184
"1287","26109","Menominee County, Michigan",9726,266,8200,295,6732,243,858,141,7342,304,1468,211,1526,173
"1288","26111","Midland County, Michigan",34090,418,31153,540,27060,628,1215,217,29938,618,4093,445,2937,402
"1289","26113","Missaukee County, Michigan",5845,192,5193,209,4009,176,321,52,4872,212,1184,125,652,91
"1290","26115","Monroe County, Michigan",61523,533,56706,686,46104,797,3010,356,53696,743,10602,806,4817,542
"1291","26117","Montcalm County, Michigan",23686,339,20676,410,15704,464,1362,231,19314,448,4972,353,3010,285
"1292","26119","Montmorency County, Michigan",4305,201,3720,214,2955,207,350,67,3370,205,765,137,585,102
"1293","26121","Muskegon County, Michigan",66122,684,59729,818,45946,891,3009,325,56720,824,13783,838,6393,515
"1294","26123","Newaygo County, Michigan",18892,321,16697,360,13378,381,1347,173,15350,380,3319,296,2195,195
"1295","26125","Oakland County, Michigan",520393,1674,495484,1993,443956,2638,17452,1038,478032,2171,51528,1910,24909,1181
"1296","26127","Oceana County, Michigan",9789,266,8811,282,6970,244,563,102,8248,283,1841,185,978,128
"1297","26129","Ogemaw County, Michigan",8999,267,7894,260,6216,266,683,89,7211,250,1678,177,1105,135
"1298","26131","Ontonagon County, Michigan",2710,91,2333,87,2006,92,294,57,2039,93,327,56,377,58
"1299","26133","Osceola County, Michigan",8675,226,7636,218,5811,189,436,74,7200,225,1825,168,1039,102
"1300","26135","Oscoda County, Michigan",3292,163,2744,162,2155,163,273,69,2471,166,589,108,548,88
"1301","26137","Otsego County, Michigan",10452,367,9763,397,8104,395,628,122,9135,378,1659,252,689,177
"1302","26139","Ottawa County, Michigan",107218,610,101866,778,89396,1244,3460,370,98406,837,12470,983,5352,545
"1303","26141","Presque Isle County, Michigan",5844,166,5057,159,4050,178,570,93,4487,158,1007,146,787,112
"1304","26143","Roscommon County, Michigan",11014,396,9854,381,8107,325,834,148,9020,383,1747,201,1160,188
"1305","26145","Saginaw County, Michigan",77995,594,70288,777,55527,938,3726,342,66562,836,14761,811,7707,564
"1306","26147","St. Clair County, Michigan",65362,585,60223,707,48968,940,3183,374,57040,711,11255,709,5139,484
"1307","26149","St. Joseph County, Michigan",23670,404,20830,467,16296,481,1185,157,19645,487,4534,442,2840,314
"1308","26151","Sanilac County, Michigan",17086,250,15223,236,11638,288,1181,156,14042,269,3585,297,1863,152
"1309","26153","Schoolcraft County, Michigan",3607,137,3203,152,2574,150,377,91,2826,161,629,109,404,110
"1310","26155","Shiawassee County, Michigan",27704,326,25147,439,20190,521,1293,202,23854,464,4957,434,2557,280
"1311","26157","Tuscola County, Michigan",21328,315,18910,376,14704,404,1438,223,17472,388,4206,263,2418,283
"1312","26159","Van Buren County, Michigan",29148,568,26908,520,21808,552,1386,257,25522,519,5100,456,2240,287
"1313","26161","Washtenaw County, Michigan",147185,861,142333,974,130187,1239,4334,346,137999,994,12146,823,4852,384
"1314","26163","Wayne County, Michigan",685635,2375,625495,2706,488347,3401,25416,889,600079,2579,137148,2871,60140,1789
"1315","26165","Wexford County, Michigan",13002,247,11711,286,9347,340,556,92,11155,295,2364,265,1291,213
"1316","27001","Aitkin County, Minnesota",6595,177,5711,179,4594,160,511,70,5200,170,1117,109,884,103
"1317","27003","Anoka County, Minnesota",132559,550,126298,698,113234,937,5734,582,120564,854,13064,851,6261,530
"1318","27005","Becker County, Minnesota",13780,249,12609,260,10181,254,695,127,11914,273,2428,220,1171,142
"1319","27007","Beltrami County, Minnesota",17555,261,15975,329,13792,363,1008,192,14967,368,2183,282,1580,237
"1320","27009","Benton County, Minnesota",16351,301,15314,361,12782,408,912,187,14402,365,2532,311,1037,166
"1321","27011","Big Stone County, Minnesota",2276,83,2013,95,1678,103,136,38,1877,96,335,63,263,51
"1322","27013","Blue Earth County, Minnesota",26630,417,25195,474,22558,592,1316,223,23879,510,2637,349,1435,204
"1323","27015","Brown County, Minnesota",10773,252,9799,266,8255,293,715,145,9084,274,1544,187,974,150
"1324","27017","Carlton County, Minnesota",13587,372,12431,386,9835,429,751,157,11680,379,2596,323,1156,181
"1325","27019","Carver County, Minnesota",38213,323,36956,382,33963,477,1220,249,35736,468,2993,386,1257,179
"1326","27021","Cass County, Minnesota",12431,244,11347,234,9194,213,717,72,10630,232,2153,144,1084,98
"1327","27023","Chippewa County, Minnesota",5240,126,4683,164,3647,200,259,82,4424,179,1036,200,557,122
"1328","27025","Chisago County, Minnesota",20565,268,19197,282,17134,313,810,154,18387,298,2063,239,1368,187
"1329","27027","Clay County, Minnesota",24998,356,23205,413,20517,492,1132,242,22073,453,2688,311,1793,262
"1330","27029","Clearwater County, Minnesota",3215,98,2801,104,2274,101,236,44,2565,104,527,67,414,58
"1331","27031","Cook County, Minnesota",2499,166,2352,166,2028,169,294,61,2058,164,324,81,147,56
"1332","27033","Cottonwood County, Minnesota",4666,127,4143,126,3473,147,248,52,3895,130,670,106,523,96
"1333","27035","Crow Wing County, Minnesota",27539,412,25638,474,21320,566,1431,216,24207,453,4318,367,1901,235
"1334","27037","Dakota County, Minnesota",166790,601,160620,911,146274,1172,5439,520,155181,1046,14346,957,6170,616
"1335","27039","Dodge County, Minnesota",7722,152,7203,178,6358,171,360,97,6843,196,845,119,519,89
"1336","27041","Douglas County, Minnesota",17030,284,15816,366,13534,362,962,152,14854,360,2282,236,1214,197
"1337","27043","Faribault County, Minnesota",5979,163,5269,177,4326,170,377,66,4892,161,943,117,710,87
"1338","27045","Fillmore County, Minnesota",8414,149,7442,146,6401,158,560,64,6882,148,1041,102,972,93
"1339","27047","Freeborn County, Minnesota",12844,225,11481,281,9354,341,706,114,10775,267,2127,259,1363,179
"1340","27049","Goodhue County, Minnesota",19580,239,17890,308,15007,391,866,141,17024,328,2883,306,1690,225
"1341","27051","Grant County, Minnesota",2512,83,2303,82,1927,80,138,24,2165,80,376,54,209,41
"1342","27053","Hennepin County, Minnesota",523528,1640,499522,1923,452363,2417,18156,921,481366,1936,47159,1601,24006,1296
"1343","27055","Houston County, Minnesota",8104,135,7313,157,6219,192,464,90,6849,160,1094,153,791,125
"1344","27057","Hubbard County, Minnesota",8622,202,7808,207,6570,211,525,91,7283,217,1238,146,814,113
"1345","27059","Isanti County, Minnesota",15298,193,14206,229,12117,318,727,149,13479,276,2089,253,1092,159
"1346","27061","Itasca County, Minnesota",18210,353,16380,384,13594,457,1057,146,15323,348,2786,238,1830,217
"1347","27063","Jackson County, Minnesota",4374,129,3957,141,3354,135,270,62,3687,136,603,101,417,74
"1348","27065","Kanabec County, Minnesota",6471,131,5718,165,4565,191,349,68,5369,152,1153,116,753,97
"1349","27067","Kandiyohi County, Minnesota",16926,330,15637,352,12795,341,673,120,14964,335,2842,302,1289,201
"1350","27069","Kittson County, Minnesota",1668,70,1467,63,1243,62,108,29,1359,62,224,49,201,44
"1351","27071","Koochiching County, Minnesota",5663,200,4992,230,3984,225,476,136,4516,259,1008,202,671,153
"1352","27073","Lac qui Parle County, Minnesota",2841,91,2442,97,2122,96,195,33,2247,87,320,58,399,50
"1353","27075","Lake County, Minnesota",5031,184,4481,198,3952,203,389,91,4092,192,529,98,550,108
"1354","27077","Lake of the Woods County, Minnesota",1403,126,1234,122,1014,117,104,41,1130,130,220,67,169,74
"1355","27079","Le Sueur County, Minnesota",11210,139,10448,166,8513,231,503,82,9945,198,1935,194,762,113
"1356","27081","Lincoln County, Minnesota",2438,77,2128,78,1778,77,128,29,2000,77,350,47,310,43
"1357","27083","Lyon County, Minnesota",9849,255,9152,262,7878,276,487,107,8665,263,1274,199,697,127
"1358","27085","McLeod County, Minnesota",14614,239,13359,314,11635,401,752,156,12607,350,1724,271,1255,217
"1359","27087","Mahnomen County, Minnesota",1863,51,1579,54,1083,51,84,22,1495,57,496,49,284,34
"1360","27089","Marshall County, Minnesota",3698,91,3294,100,2649,97,281,49,3013,107,645,72,404,57
"1361","27091","Martin County, Minnesota",8739,278,7933,330,6276,361,484,103,7449,317,1657,250,806,152
"1362","27093","Meeker County, Minnesota",8964,152,8165,171,6890,207,553,104,7612,203,1275,158,799,107
"1363","27095","Mille Lacs County, Minnesota",10389,188,9439,197,7369,253,457,71,8982,200,2070,211,950,140
"1364","27097","Morrison County, Minnesota",13530,180,11985,262,9796,278,962,167,11023,283,2189,185,1545,182
"1365","27099","Mower County, Minnesota",15596,269,14274,311,11402,456,738,142,13536,351,2872,335,1322,163
"1366","27101","Murray County, Minnesota",3440,97,3039,99,2453,106,214,42,2825,92,586,74,401,51
"1367","27103","Nicollet County, Minnesota",12733,320,11695,343,10273,375,427,84,11268,346,1422,218,1038,199
"1368","27105","Nobles County, Minnesota",7606,206,6894,236,5181,309,420,98,6474,219,1713,238,712,127
"1369","27107","Norman County, Minnesota",2670,78,2316,90,1915,87,106,27,2210,97,401,70,354,60
"1370","27109","Olmsted County, Minnesota",64611,545,61304,711,54907,765,2570,285,58734,749,6397,558,3307,422
"1371","27111","Otter Tail County, Minnesota",24838,357,22477,416,18242,395,1173,134,21304,434,4235,331,2361,267
"1372","27113","Pennington County, Minnesota",5987,150,5559,167,4703,184,326,84,5233,157,856,154,428,94
"1373","27115","Pine County, Minnesota",10916,279,9696,280,7721,279,731,122,8965,312,1975,160,1220,129
"1374","27117","Pipestone County, Minnesota",3957,103,3549,114,2771,129,188,59,3361,125,778,124,408,80
"1375","27119","Polk County, Minnesota",12363,265,11182,296,9092,322,732,147,10450,322,2090,260,1181,180
"1376","27121","Pope County, Minnesota",4892,125,4393,139,3747,148,290,58,4103,148,646,83,499,88
"1377","27123","Ramsey County, Minnesota",215740,897,203735,996,176894,1479,9077,551,194658,990,26841,1274,12005,612
"1378","27125","Red Lake County, Minnesota",1652,50,1442,59,1152,64,128,32,1314,60,290,41,210,43
"1379","27127","Redwood County, Minnesota",6140,144,5455,148,4496,166,284,54,5171,144,959,128,685,86
"1380","27129","Renville County, Minnesota",5861,133,5158,162,4195,184,396,67,4762,131,963,105,703,90
"1381","27131","Rice County, Minnesota",23078,394,21399,500,17629,550,1216,216,20183,488,3770,452,1679,277
"1382","27133","Rock County, Minnesota",3921,112,3614,124,2976,137,220,52,3394,140,638,113,307,80
"1383","27135","Roseau County, Minnesota",5689,172,5244,171,4164,152,295,69,4949,179,1080,153,445,76
"1384","27137","St. Louis County, Minnesota",85532,689,77773,774,64549,1036,4101,353,73672,819,13224,656,7759,503
"1385","27139","Scott County, Minnesota",52310,366,50495,452,46297,609,1419,269,49076,507,4198,457,1815,245
"1386","27141","Sherburne County, Minnesota",33825,380,32122,504,28534,574,1040,210,31082,525,3588,535,1703,272
"1387","27143","Sibley County, Minnesota",5864,118,5228,122,4178,188,343,75,4885,124,1050,139,636,79
"1388","27145","Stearns County, Minnesota",60098,490,56158,585,47299,796,2931,349,53227,689,8859,656,3940,351
"1389","27147","Steele County, Minnesota",14911,182,13644,243,11521,365,645,140,12999,248,2123,278,1267,184
"1390","27149","Stevens County, Minnesota",3764,138,3507,159,2887,196,189,58,3318,173,620,164,257,67
"1391","27151","Swift County, Minnesota",4215,110,3608,136,2961,154,246,48,3362,137,647,100,607,100
"1392","27153","Todd County, Minnesota",9590,194,8076,197,6114,228,599,100,7477,192,1962,202,1514,132
"1393","27155","Traverse County, Minnesota",1424,60,1216,67,939,70,99,27,1117,67,277,54,208,46
"1394","27157","Wabasha County, Minnesota",9047,197,8181,224,6864,249,405,74,7776,218,1317,165,866,137
"1395","27159","Wadena County, Minnesota",5582,192,4955,181,3908,192,495,115,4460,182,1047,160,627,109
"1396","27161","Waseca County, Minnesota",7533,124,6613,175,5576,211,335,86,6278,181,1037,166,920,140
"1397","27163","Washington County, Minnesota",98647,634,95041,730,87200,915,2921,311,92120,744,7841,691,3606,392
"1398","27165","Watonwan County, Minnesota",4272,107,3874,150,3022,179,338,84,3536,167,852,152,398,105
"1399","27167","Wilkin County, Minnesota",2680,112,2261,141,1913,150,151,72,2110,132,348,88,419,97
"1400","27169","Winona County, Minnesota",20109,360,18907,401,16642,439,1223,205,17684,450,2265,261,1202,209
"1401","27171","Wright County, Minnesota",50290,405,47456,521,42041,781,1826,346,45630,541,5415,589,2834,343
"1402","27173","Yellow Medicine County, Minnesota",3941,115,3522,110,2918,131,192,44,3330,110,604,91,419,64
"1403","28001","Adams County, Mississippi",11353,443,9249,489,6867,507,516,155,8733,493,2382,329,2104,321
"1404","28003","Alcorn County, Mississippi",14027,435,11426,499,8391,479,648,232,10778,548,3035,427,2601,423
"1405","28005","Amite County, Mississippi",5841,257,4660,342,2888,290,230,106,4430,349,1772,318,1181,302
"1406","28007","Attala County, Mississippi",6333,256,5457,300,3687,294,263,97,5194,291,1770,281,876,193
"1407","28009","Benton County, Mississippi",2962,208,2389,213,1286,233,135,78,2254,214,1103,268,573,158
"1408","28011","Bolivar County, Mississippi",11538,345,9820,417,6989,340,383,137,9437,398,2831,360,1718,218
"1409","28013","Calhoun County, Mississippi",5672,171,4773,199,3137,229,312,86,4461,205,1636,209,899,126
"1410","28015","Carroll County, Mississippi",3913,296,3061,335,2167,310,47,41,3014,344,894,271,852,188
"1411","28017","Chickasaw County, Mississippi",6745,240,5367,295,3172,346,258,113,5109,284,2195,273,1378,218
"1412","28019","Choctaw County, Mississippi",3492,145,2945,175,2080,181,281,136,2664,168,865,143,547,124
"1413","28021","Claiborne County, Mississippi",2577,190,1900,201,1510,197,18,17,1882,202,390,111,677,163
"1414","28023","Clarke County, Mississippi",5929,251,4918,281,3435,340,212,78,4706,284,1483,277,1011,181
"1415","28025","Clay County, Mississippi",7489,260,6246,342,4039,410,167,84,6079,340,2207,353,1243,259
"1416","28027","Coahoma County, Mississippi",8301,302,6820,320,4485,314,277,102,6543,323,2335,325,1481,220
"1417","28029","Copiah County, Mississippi",9711,340,7763,427,5697,432,251,106,7512,421,2066,332,1948,338
"1418","28031","Covington County, Mississippi",6831,306,5972,397,3543,452,103,46,5869,402,2429,397,859,282
"1419","28033","DeSoto County, Mississippi",67024,611,64010,679,52780,955,1766,308,62244,686,11230,922,3014,392
"1420","28035","Forrest County, Mississippi",28867,572,26001,670,19294,806,727,227,25274,691,6707,710,2866,451
"1421","28037","Franklin County, Mississippi",3072,226,2602,212,1856,202,121,57,2481,218,746,152,470,138
"1422","28039","George County, Mississippi",8577,276,7266,286,4947,373,226,108,7040,297,2319,308,1311,230
"1423","28041","Greene County, Mississippi",3742,301,3012,306,1949,291,37,38,2975,296,1063,214,730,188
"1424","28043","Grenada County, Mississippi",8631,358,7559,375,5148,416,323,150,7236,398,2411,372,1072,237
"1425","28045","Hancock County, Mississippi",18864,502,17282,644,13365,715,661,199,16621,629,3917,639,1582,368
"1426","28047","Harrison County, Mississippi",79064,845,73051,1035,56385,1359,2478,451,70573,1025,16666,1068,6013,658
"1427","28049","Hinds County, Mississippi",89891,1055,80922,1307,59339,1257,2335,323,78587,1360,21583,1167,8969,833
"1428","28051","Holmes County, Mississippi",5674,244,4441,266,2653,246,232,85,4209,258,1788,239,1233,214
"1429","28053","Humphreys County, Mississippi",2941,120,2541,137,1655,171,84,49,2457,145,886,188,400,97
"1430","28055","Issaquena County, Mississippi",378,62,218,60,126,44,9,10,209,61,92,45,160,58
"1431","28057","Itawamba County, Mississippi",8709,296,7493,372,5023,408,350,139,7143,377,2470,370,1216,273
"1432","28059","Jackson County, Mississippi",54183,677,50184,835,39897,921,1635,437,48549,871,10287,931,3999,570
"1433","28061","Jasper County, Mississippi",6319,248,5040,381,3229,388,300,134,4740,361,1811,314,1279,294
"1434","28063","Jefferson County, Mississippi",2412,900,2096,798,1538,552,44,68,2052,791,558,322,316,284
"1435","28065","Jefferson Davis County, Mississippi",4305,229,3495,263,2269,252,121,72,3374,267,1226,229,810,212
"1436","28067","Jones County, Mississippi",24087,496,20954,620,13483,780,839,328,20115,623,7471,760,3133,496
"1437","28069","Kemper County, Mississippi",3196,230,2544,253,1609,274,67,55,2477,261,935,223,652,198
"1438","28071","Lafayette County, Mississippi",18970,704,17782,770,14939,774,514,139,17268,749,2843,446,1188,280
"1439","28073","Lamar County, Mississippi",24929,431,23628,603,19030,764,531,188,23097,651,4598,495,1301,397
"1440","28075","Lauderdale County, Mississippi",28452,534,25400,653,17791,798,1102,277,24298,663,7609,726,3052,397
"1441","28077","Lawrence County, Mississippi",4439,214,3607,224,2372,246,308,136,3299,212,1235,239,832,160
"1442","28079","Leake County, Mississippi",7424,265,6085,303,3442,382,150,65,5935,298,2643,347,1339,246
"1443","28081","Lee County, Mississippi",31674,520,28008,622,20170,777,859,167,27149,622,7838,626,3666,433
"1444","28083","Leflore County, Mississippi",9534,358,6970,398,5598,394,939,174,6031,383,1372,266,2564,308
"1445","28085","Lincoln County, Mississippi",12949,412,10784,538,7588,689,568,217,10216,534,3196,541,2165,452
"1446","28087","Lowndes County, Mississippi",22315,549,19513,585,13855,802,482,152,19031,585,5658,567,2802,332
"1447","28089","Madison County, Mississippi",41805,572,40067,629,33374,888,991,253,39076,646,6693,721,1738,330
"1448","28091","Marion County, Mississippi",9175,364,7766,474,5032,435,349,120,7417,473,2734,391,1409,310
"1449","28093","Marshall County, Mississippi",12542,370,11087,466,6290,555,497,202,10590,485,4797,478,1455,315
"1450","28095","Monroe County, Mississippi",13465,350,11567,400,7397,508,492,141,11075,377,4170,418,1898,246
"1451","28097","Montgomery County, Mississippi",3802,246,3096,225,2161,208,283,87,2813,227,935,210,706,199
"1452","28099","Neshoba County, Mississippi",10024,265,8460,298,5181,445,298,124,8162,313,3279,394,1564,256
"1453","28101","Newton County, Mississippi",7533,308,6443,360,4153,329,228,87,6215,371,2290,334,1090,202
"1454","28103","Noxubee County, Mississippi",3657,232,2884,226,1863,267,83,59,2801,226,1021,227,773,163
"1455","28105","Oktibbeha County, Mississippi",21011,562,19172,669,16149,689,247,123,18925,692,3023,489,1839,357
"1456","28107","Panola County, Mississippi",12114,403,9803,526,6656,518,336,123,9467,530,3147,451,2311,374
"1457","28109","Pearl River County, Mississippi",20465,500,18053,585,13889,646,1191,307,16862,613,4164,570,2412,422
"1458","28111","Perry County, Mississippi",4371,226,3765,268,2576,305,117,63,3648,268,1189,211,606,161
"1459","28113","Pike County, Mississippi",14838,435,12750,578,8595,553,496,174,12254,610,4155,435,2088,383
"1460","28115","Pontotoc County, Mississippi",11394,303,9572,426,6689,447,276,96,9296,418,2883,343,1822,311
"1461","28117","Prentiss County, Mississippi",9088,385,7688,462,5324,440,287,154,7401,463,2364,394,1400,254
"1462","28119","Quitman County, Mississippi",2596,95,2011,114,1130,123,76,35,1935,118,881,118,585,86
"1463","28121","Rankin County, Mississippi",58297,750,55245,878,46407,1249,1995,456,53250,895,8838,1006,3052,429
"1464","28123","Scott County, Mississippi",9776,297,8371,335,5342,407,235,107,8136,364,3029,388,1405,242
"1465","28125","Sharkey County, Mississippi",1364,130,1089,129,709,114,73,51,1016,133,380,92,275,87
"1466","28127","Simpson County, Mississippi",9090,402,7835,434,5151,495,355,157,7480,416,2684,415,1255,232
"1467","28129","Smith County, Mississippi",5370,251,4534,305,2548,319,160,71,4374,316,1986,306,836,196
"1468","28131","Stone County, Mississippi",6429,339,6047,315,4554,383,210,129,5837,342,1493,345,382,186
"1469","28133","Sunflower County, Mississippi",8073,270,6638,323,4477,303,460,115,6178,333,2161,286,1435,211
"1470","28135","Tallahatchie County, Mississippi",4101,216,3433,231,2159,254,234,102,3199,218,1274,237,668,147
"1471","28137","Tate County, Mississippi",10375,324,8939,436,6849,434,355,141,8584,427,2090,332,1436,298
"1472","28139","Tippah County, Mississippi",7854,432,6580,498,4349,479,486,248,6094,549,2231,419,1274,252
"1473","28141","Tishomingo County, Mississippi",8030,273,6915,366,4180,371,271,156,6644,376,2735,321,1115,246
"1474","28143","Tunica County, Mississippi",3635,195,3231,242,1859,236,97,68,3134,236,1372,267,404,124
"1475","28145","Union County, Mississippi",9880,308,8580,348,6053,398,268,106,8312,366,2527,317,1300,221
"1476","28147","Walthall County, Mississippi",5353,351,4186,377,2792,348,286,142,3900,379,1394,303,1167,282
"1477","28149","Warren County, Mississippi",17091,481,15571,512,11158,617,369,129,15202,512,4413,650,1520,250
"1478","28151","Washington County, Mississippi",17376,399,13935,544,9799,434,708,168,13227,531,4136,436,3441,353
"1479","28153","Wayne County, Mississippi",7518,331,6575,344,4728,358,373,146,6202,374,1847,387,943,230
"1480","28155","Webster County, Mississippi",3941,211,3342,251,2234,248,99,52,3243,255,1108,180,599,145
"1481","28157","Wilkinson County, Mississippi",3316,251,2584,253,1702,294,94,53,2490,261,882,241,732,162
"1482","28159","Winston County, Mississippi",6841,266,5519,309,3286,313,143,72,5376,308,2233,281,1322,240
"1483","28161","Yalobusha County, Mississippi",5099,299,4203,318,2517,284,193,78,4010,304,1686,226,896,201
"1484","28163","Yazoo County, Mississippi",8645,478,7099,484,4789,517,97,54,7002,475,2310,372,1546,252
"1485","29001","Adair County, Missouri",8847,336,8009,345,6730,338,370,99,7639,356,1279,236,838,140
"1486","29003","Andrew County, Missouri",6880,165,6218,216,4886,251,283,80,5935,219,1332,233,662,163
"1487","29005","Atchison County, Missouri",2374,88,2122,90,1595,114,130,31,1992,92,527,88,252,52
"1488","29007","Audrain County, Missouri",9032,261,8052,299,6241,325,442,125,7610,292,1811,234,980,157
"1489","29009","Barry County, Missouri",13570,430,12103,474,8612,530,585,165,11518,485,3491,403,1467,251
"1490","29011","Barton County, Missouri",4522,181,3990,205,3054,280,231,107,3759,196,936,212,532,122
"1491","29013","Bates County, Missouri",5984,179,5260,210,4000,215,425,105,4835,203,1260,171,724,133
"1492","29015","Benton County, Missouri",7891,276,6812,322,5270,296,492,132,6320,340,1542,190,1079,214
"1493","29017","Bollinger County, Missouri",3775,182,3159,224,1977,220,138,55,3021,232,1182,195,616,138
"1494","29019","Boone County, Missouri",73113,786,69680,925,61648,1206,2176,370,67504,1016,8032,781,3433,443
"1495","29021","Buchanan County, Missouri",33243,483,29928,609,22567,701,1159,202,28769,657,7361,581,3315,399
"1496","29023","Butler County, Missouri",16031,438,13690,523,9428,553,741,181,12949,535,4262,586,2341,369
"1497","29025","Caldwell County, Missouri",3396,139,2928,143,2259,131,184,52,2744,147,669,106,468,80
"1498","29027","Callaway County, Missouri",15814,434,14696,468,12023,492,753,215,13943,453,2673,361,1118,224
"1499","29029","Camden County, Missouri",16216,519,14862,515,12576,572,682,148,14180,496,2286,273,1354,269
"1500","29031","Cape Girardeau County, Missouri",30913,520,28432,649,23084,729,1200,267,27232,665,5348,474,2481,438
"1501","29033","Carroll County, Missouri",3339,158,2964,154,2333,149,228,84,2736,159,631,122,375,88
"1502","29035","Carter County, Missouri",1887,138,1649,152,1137,166,93,48,1556,159,512,123,238,70
"1503","29037","Cass County, Missouri",41113,379,38719,526,32944,719,1466,269,37253,562,5775,575,2394,377
"1504","29039","Cedar County, Missouri",5504,276,4783,283,3610,310,287,113,4496,287,1173,242,721,228
"1505","29041","Chariton County, Missouri",2563,120,2229,117,1801,128,335,81,1894,111,428,62,334,61
"1506","29043","Christian County, Missouri",32631,426,30919,538,25554,662,1125,271,29794,537,5365,476,1712,319
"1507","29045","Clark County, Missouri",2364,115,1983,123,1321,134,127,45,1856,115,662,105,381,88
"1508","29047","Clay County, Missouri",98033,756,93189,973,79930,1246,3368,422,89821,1050,13259,934,4844,543
"1509","29049","Clinton County, Missouri",7946,236,7090,310,5496,372,294,99,6796,320,1594,297,856,218
"1510","29051","Cole County, Missouri",29867,609,27740,672,22808,701,1400,291,26340,716,4932,596,2127,328
"1511","29053","Cooper County, Missouri",6091,244,5373,266,4358,252,399,84,4974,253,1015,145,718,138
"1512","29055","Crawford County, Missouri",9272,337,7846,347,5941,329,656,131,7190,373,1905,289,1426,224
"1513","29057","Dade County, Missouri",2992,152,2570,165,1713,135,138,41,2432,158,857,110,422,92
"1514","29059","Dallas County, Missouri",6512,220,5845,258,4322,348,373,140,5472,322,1523,323,667,165
"1515","29061","Daviess County, Missouri",3005,101,2573,126,2009,124,194,53,2379,126,564,95,432,76
"1516","29063","DeKalb County, Missouri",3772,151,3105,198,2201,220,146,51,2959,194,904,149,667,166
"1517","29065","Dent County, Missouri",5923,202,5086,255,3730,249,462,146,4624,270,1356,233,837,167
"1518","29067","Douglas County, Missouri",4532,208,3870,241,2991,247,591,164,3279,286,879,172,662,155
"1519","29069","Dunklin County, Missouri",11167,268,9672,305,6691,331,529,121,9143,291,2981,270,1495,199
"1520","29071","Franklin County, Missouri",40612,581,37503,702,31051,831,2330,428,35173,766,6452,685,3109,384
"1521","29073","Gasconade County, Missouri",5872,221,5178,263,4164,256,349,94,4829,253,1014,174,694,119
"1522","29075","Gentry County, Missouri",2301,102,1883,101,1417,109,119,46,1764,112,466,86,418,80
"1523","29077","Greene County, Missouri",129367,800,118841,1066,99462,1521,5144,548,113697,1113,19379,1155,10526,691
"1524","29079","Grundy County, Missouri",3667,187,3041,187,2434,175,226,59,2815,189,607,116,626,122
"1525","29081","Harrison County, Missouri",3094,143,2677,148,2063,166,158,55,2519,149,614,128,417,79
"1526","29083","Henry County, Missouri",9190,255,8204,286,6092,305,537,100,7667,300,2112,262,986,174
"1527","29085","Hickory County, Missouri",3408,238,2634,261,1868,244,185,105,2449,273,766,174,774,146
"1528","29087","Holt County, Missouri",1794,74,1504,65,1177,70,54,21,1450,68,327,57,290,47
"1529","29089","Howard County, Missouri",3186,155,2816,148,2304,144,274,70,2542,144,512,103,370,79
"1530","29091","Howell County, Missouri",15543,368,13858,408,10583,477,1262,318,12596,445,3275,387,1685,251
"1531","29093","Iron County, Missouri",3649,155,3015,148,2379,161,247,90,2768,141,636,100,634,98
"1532","29095","Jackson County, Missouri",295018,1349,275728,1752,223628,2489,11114,746,264614,1885,52100,1954,19290,1087
"1533","29097","Jasper County, Missouri",47105,572,43309,744,33163,789,1684,325,41625,753,10146,855,3796,444
"1534","29099","Jefferson County, Missouri",85737,755,80872,825,67701,1210,3469,541,77403,945,13171,1000,4865,465
"1535","29101","Johnson County, Missouri",20537,486,19646,528,16827,627,863,222,18783,536,2819,382,891,185
"1536","29103","Knox County, Missouri",1196,90,874,92,707,91,100,41,774,93,167,50,322,69
"1537","29105","Laclede County, Missouri",14380,337,12952,433,9376,528,552,168,12400,433,3576,415,1428,292
"1538","29107","Lafayette County, Missouri",12083,370,10970,414,8695,399,768,166,10202,423,2275,339,1113,210
"1539","29109","Lawrence County, Missouri",14472,333,13057,418,9219,532,846,230,12211,492,3838,523,1415,267
"1540","29111","Lewis County, Missouri",3342,150,2866,149,2108,146,276,76,2590,152,758,131,476,88
"1541","29113","Lincoln County, Missouri",21404,406,20331,433,17164,445,924,211,19407,520,3167,482,1073,255
"1542","29115","Linn County, Missouri",4759,152,4110,180,3000,197,258,65,3852,199,1110,174,649,140
"1543","29117","Livingston County, Missouri",5488,200,4584,215,3466,210,313,92,4271,201,1118,208,904,157
"1544","29119","McDonald County, Missouri",8234,225,6833,283,4562,370,527,184,6306,296,2271,319,1401,241
"1545","29121","Macon County, Missouri",5695,189,4827,220,3862,204,358,93,4469,207,965,137,868,146
"1546","29123","Madison County, Missouri",4607,219,3954,236,3024,256,223,81,3731,235,930,171,653,148
"1547","29125","Maries County, Missouri",3633,165,2974,195,2263,232,268,104,2706,204,711,175,659,123
"1548","29127","Marion County, Missouri",11442,271,10368,318,8148,373,675,239,9693,359,2220,314,1074,216
"1549","29129","Mercer County, Missouri",1228,98,991,99,820,98,105,37,886,95,171,50,237,60
"1550","29131","Miller County, Missouri",10084,273,9275,326,7292,405,781,235,8494,345,1983,307,809,175
"1551","29133","Mississippi County, Missouri",4606,173,3726,219,2712,193,288,111,3438,228,1014,186,880,165
"1552","29135","Moniteau County, Missouri",5504,185,4775,221,3831,215,306,85,4469,222,944,153,729,142
"1553","29137","Monroe County, Missouri",3506,183,3019,189,2184,176,148,56,2871,193,835,148,487,102
"1554","29139","Montgomery County, Missouri",4635,190,4022,182,3235,196,269,65,3753,173,787,130,613,112
"1555","29141","Morgan County, Missouri",7566,325,6388,352,4951,309,563,169,5825,377,1437,241,1178,225
"1556","29143","New Madrid County, Missouri",6816,200,5828,251,3952,251,373,116,5455,257,1876,206,988,180
"1557","29145","Newton County, Missouri",21932,347,20235,448,15176,563,896,170,19339,494,5059,545,1697,288
"1558","29147","Nodaway County, Missouri",8358,259,7576,284,6340,300,395,90,7181,284,1236,208,782,153
"1559","29149","Oregon County, Missouri",3423,184,2935,223,2181,227,175,60,2760,221,754,190,488,130
"1560","29151","Osage County, Missouri",5202,184,4569,213,3712,240,228,75,4341,215,857,137,633,113
"1561","29153","Ozark County, Missouri",3591,166,2942,205,2173,199,407,138,2535,223,769,170,649,137
"1562","29155","Pemiscot County, Missouri",6162,202,5110,221,3279,264,268,92,4842,199,1831,219,1052,174
"1563","29157","Perry County, Missouri",7305,194,6361,232,4912,246,266,73,6095,243,1449,235,944,179
"1564","29159","Pettis County, Missouri",16608,297,14967,347,12140,418,1002,186,13965,354,2827,330,1641,227
"1565","29161","Phelps County, Missouri",17878,423,16682,459,14085,552,835,173,15847,469,2597,362,1196,203
"1566","29163","Pike County, Missouri",6468,225,5565,250,3868,253,292,86,5273,244,1697,206,903,150
"1567","29165","Platte County, Missouri",42154,394,40880,518,36216,663,1160,202,39720,554,4664,550,1274,289
"1568","29167","Polk County, Missouri",11633,321,10379,408,8115,382,569,132,9810,420,2264,294,1254,226
"1569","29169","Pulaski County, Missouri",15506,561,14405,639,12242,654,476,172,13929,664,2163,399,1101,282
"1570","29171","Putnam County, Missouri",1704,159,1406,144,1010,149,119,64,1287,149,396,97,298,89
"1571","29173","Ralls County, Missouri",4009,179,3523,209,2875,195,319,99,3204,211,648,135,486,116
"1572","29175","Randolph County, Missouri",8856,295,7893,294,6161,360,634,140,7259,298,1732,261,963,202
"1573","29177","Ray County, Missouri",8604,237,7802,243,6226,269,451,120,7351,246,1576,214,802,172
"1574","29179","Reynolds County, Missouri",2253,133,1897,144,1504,133,171,63,1726,150,393,101,356,85
"1575","29181","Ripley County, Missouri",3947,186,3271,177,2566,192,430,116,2841,189,705,127,676,129
"1576","29183","St. Charles County, Missouri",153164,1150,147462,1396,136621,1389,5256,448,142206,1369,10841,725,5702,556
"1577","29185","St. Clair County, Missouri",3955,192,3438,200,2628,194,231,59,3207,222,810,132,517,113
"1578","29186","Ste. Genevieve County, Missouri",7088,241,6229,291,4820,294,165,78,6064,305,1409,213,859,198
"1579","29187","St. Francois County, Missouri",23419,584,20906,566,15669,582,806,195,20100,600,5237,574,2513,409
"1580","29189","St. Louis County, Missouri",412858,1490,387907,1697,336098,2273,16683,1001,371224,1837,51809,2009,24951,1105
"1581","29195","Saline County, Missouri",7809,318,6962,366,5414,393,627,133,6335,397,1548,254,847,199
"1582","29197","Schuyler County, Missouri",1252,80,1025,72,811,69,40,22,985,71,214,58,227,60
"1583","29199","Scotland County, Missouri",1639,97,1385,107,1160,115,199,68,1186,94,225,64,254,76
"1584","29201","Scott County, Missouri",15001,282,13313,345,9938,408,693,177,12620,378,3375,366,1688,251
"1585","29203","Shannon County, Missouri",2730,165,2295,154,1663,160,256,95,2039,164,632,138,435,112
"1586","29205","Shelby County, Missouri",2329,117,2049,114,1478,126,136,38,1913,113,571,107,280,59
"1587","29207","Stoddard County, Missouri",11293,262,9877,319,6880,383,607,143,9270,327,2997,309,1416,207
"1588","29209","Stone County, Missouri",12276,517,11431,528,9574,491,691,155,10740,518,1857,287,845,204
"1589","29211","Sullivan County, Missouri",2020,115,1757,112,1317,98,87,27,1670,114,440,87,263,53
"1590","29213","Taney County, Missouri",21249,539,19630,523,16350,567,1115,246,18515,540,3280,434,1619,306
"1591","29215","Texas County, Missouri",9344,299,8217,354,6141,392,801,171,7416,380,2076,335,1127,227
"1592","29217","Vernon County, Missouri",7783,228,7133,256,5465,291,502,143,6631,263,1668,259,650,132
"1593","29219","Warren County, Missouri",12755,305,11876,313,9519,415,597,177,11279,325,2357,381,879,240
"1594","29221","Washington County, Missouri",8801,282,7489,258,5251,337,384,102,7105,290,2238,304,1312,214
"1595","29223","Wayne County, Missouri",4280,241,3519,260,2747,257,456,150,3063,249,772,177,761,167
"1596","29225","Webster County, Missouri",13700,353,12021,404,9271,476,553,124,11468,399,2750,342,1679,253
"1597","29227","Worth County, Missouri",725,73,624,72,439,65,38,18,586,70,185,46,101,31
"1598","29229","Wright County, Missouri",6721,292,5914,288,4130,360,293,95,5621,297,1784,321,807,129
"1599","29510","St. Louis city, Missouri",141161,1000,125094,1400,97143,1546,5165,542,119929,1427,27951,1425,16067,1091
"1600","30001","Beaverhead County, Montana",3984,145,3673,153,3041,201,366,132,3307,177,632,162,311,75
"1601","30003","Big Horn County, Montana",3534,141,2931,181,2317,168,237,68,2694,178,614,110,603,129
"1602","30005","Blaine County, Montana",2248,101,1947,110,1497,94,195,58,1752,118,450,73,301,61
"1603","30007","Broadwater County, Montana",2757,127,2339,176,1906,197,171,60,2168,178,433,138,418,149
"1604","30009","Carbon County, Montana",4512,187,4166,198,3344,170,268,74,3898,204,822,138,346,89
"1605","30011","Carter County, Montana",618,60,554,57,502,60,106,33,448,60,52,23,64,30
"1606","30013","Cascade County, Montana",34194,440,30582,487,25471,587,1771,268,28811,528,5111,537,3612,343
"1607","30015","Chouteau County, Montana",2201,92,1824,101,1553,117,172,44,1652,110,271,86,377,69
"1608","30017","Custer County, Montana",4872,161,4485,168,3858,185,445,103,4040,178,627,133,387,110
"1609","30019","Daniels County, Montana",784,70,660,65,538,71,37,21,623,67,122,49,124,46
"1610","30021","Dawson County, Montana",3893,175,3516,199,2946,229,125,65,3391,194,570,158,377,122
"1611","30023","Deer Lodge County, Montana",4161,268,3614,266,2721,232,241,88,3373,264,893,165,547,140
"1612","30025","Fallon County, Montana",1184,98,1132,106,909,108,70,34,1062,111,223,82,52,26
"1613","30027","Fergus County, Montana",5208,153,4677,197,3700,278,525,136,4152,226,977,217,531,139
"1614","30029","Flathead County, Montana",40780,545,37456,745,33213,758,1853,250,35603,800,4243,503,3324,520
"1615","30031","Gallatin County, Montana",46378,1692,44716,1680,41333,1710,1590,265,43126,1649,3383,444,1662,337
"1616","30033","Garfield County, Montana",404,52,359,47,289,41,48,23,311,44,70,31,45,20
"1617","30035","Glacier County, Montana",4005,177,3174,208,2326,184,295,105,2879,199,848,155,831,150
"1618","30037","Golden Valley County, Montana",349,47,276,43,239,39,28,14,248,40,37,14,73,25
"1619","30039","Granite County, Montana",1337,128,1197,123,1030,132,193,70,1004,121,167,44,140,62
"1620","30041","Hill County, Montana",6243,164,5554,208,4459,237,311,82,5243,203,1095,208,689,137
"1621","30043","Jefferson County, Montana",4604,150,4382,156,3856,189,250,58,4132,154,526,125,222,77
"1622","30045","Judith Basin County, Montana",879,63,758,66,640,61,62,24,696,64,118,32,121,40
"1623","30047","Lake County, Montana",11756,255,10444,283,8976,300,582,117,9862,300,1468,236,1312,167
"1624","30049","Lewis and Clark County, Montana",30011,376,27606,482,24597,530,1199,195,26407,514,3009,416,2405,326
"1625","30051","Liberty County, Montana",765,79,653,72,521,75,66,38,587,71,132,43,112,40
"1626","30053","Lincoln County, Montana",8458,309,7511,326,6453,369,823,182,6688,326,1058,215,947,185
"1627","30055","McCone County, Montana",829,84,760,87,664,81,26,15,734,84,96,42,69,28
"1628","30057","Madison County, Montana",3480,212,3157,215,2780,203,437,127,2720,195,377,114,323,80
"1629","30059","Meagher County, Montana",819,82,689,92,655,95,98,55,591,83,34,25,130,73
"1630","30061","Mineral County, Montana",1981,97,1809,101,1560,98,112,48,1697,108,249,68,172,59
"1631","30063","Missoula County, Montana",49437,681,46998,780,41726,935,2162,379,44836,804,5272,666,2439,355
"1632","30065","Musselshell County, Montana",2179,156,1772,168,1509,162,128,47,1644,162,263,92,407,109
"1633","30067","Park County, Montana",7920,226,7392,255,6456,295,526,170,6866,303,936,191,528,137
"1634","30069","Petroleum County, Montana",195,43,178,42,150,40,10,7,168,41,28,17,17,15
"1635","30071","Phillips County, Montana",1732,97,1492,122,1253,122,81,37,1411,132,239,68,240,96
"1636","30073","Pondera County, Montana",2188,109,1955,124,1679,123,191,52,1764,117,276,70,233,63
"1637","30075","Powder River County, Montana",758,77,703,78,604,74,83,32,620,71,99,35,55,32
"1638","30077","Powell County, Montana",2300,141,2018,166,1575,172,240,80,1778,168,443,127,282,142
"1639","30079","Prairie County, Montana",484,61,441,62,396,51,65,32,376,65,45,31,43,24
"1640","30081","Ravalli County, Montana",18749,345,17597,429,15475,549,1384,283,16213,452,2122,339,1152,221
"1641","30083","Richland County, Montana",4540,229,4044,253,3291,260,157,66,3887,255,753,187,496,131
"1642","30085","Roosevelt County, Montana",3122,86,2398,123,1778,123,147,48,2251,122,620,102,724,116
"1643","30087","Rosebud County, Montana",2944,116,2433,138,1918,141,212,85,2221,142,515,119,511,111
"1644","30089","Sanders County, Montana",5390,176,4688,200,3997,214,579,111,4109,230,691,153,702,144
"1645","30091","Sheridan County, Montana",1444,95,1303,102,1173,103,154,54,1149,107,130,37,141,42
"1646","30093","Silver Bow County, Montana",15028,383,13324,483,10986,546,903,196,12421,494,2338,313,1704,291
"1647","30095","Stillwater County, Montana",3733,141,3482,158,3016,149,244,65,3238,164,466,116,251,71
"1648","30097","Sweet Grass County, Montana",1389,107,1214,112,1058,108,110,45,1104,113,156,63,175,61
"1649","30099","Teton County, Montana",2428,126,2184,119,1907,126,155,43,2029,116,277,70,244,53
"1650","30101","Toole County, Montana",1805,130,1581,145,1249,138,86,44,1495,136,332,114,224,102
"1651","30103","Treasure County, Montana",335,52,298,51,247,50,35,15,263,49,51,19,37,18
"1652","30105","Valley County, Montana",2892,157,2653,165,2105,174,350,89,2303,187,548,134,239,80
"1653","30107","Wheatland County, Montana",839,67,672,62,580,64,47,20,625,61,92,41,167,57
"1654","30109","Wibaux County, Montana",422,56,363,58,292,54,48,31,315,54,71,35,59,25
"1655","30111","Yellowstone County, Montana",67000,553,62750,743,54027,861,3166,377,59584,718,8723,720,4250,510
"1656","31001","Adams County, Nebraska",12662,332,11627,385,9879,380,702,155,10925,390,1748,263,1035,209
"1657","31003","Antelope County, Nebraska",2607,115,2240,116,1800,122,131,40,2109,111,440,71,367,68
"1658","31005","Arthur County, Nebraska",180,26,163,27,139,26,15,8,148,25,24,12,17,10
"1659","31007","Banner County, Nebraska",235,35,190,29,170,30,19,12,171,28,20,12,45,20
"1660","31009","Blaine County, Nebraska",181,27,163,25,131,26,26,13,137,25,32,14,18,14
"1661","31011","Boone County, Nebraska",2215,93,1979,95,1554,104,121,32,1858,90,425,74,236,43
"1662","31013","Box Butte County, Nebraska",4576,208,4207,217,3388,234,181,84,4026,213,819,183,369,91
"1663","31015","Boyd County, Nebraska",807,55,694,58,572,66,49,19,645,59,122,28,113,33
"1664","31017","Brown County, Nebraska",1160,98,1041,94,916,103,86,42,955,97,125,54,119,48
"1665","31019","Buffalo County, Nebraska",19236,286,18033,339,14901,504,791,154,17242,340,3132,415,1203,206
"1666","31021","Burt County, Nebraska",2790,109,2441,126,1871,127,172,41,2269,121,570,100,349,76
"1667","31023","Butler County, Nebraska",3417,140,3006,144,2463,138,198,52,2808,150,543,117,411,83
"1668","31025","Cass County, Nebraska",10073,230,9407,234,8347,255,402,96,9005,239,1060,190,666,123
"1669","31027","Cedar County, Nebraska",3301,99,2804,134,2251,137,219,50,2585,126,553,101,497,85
"1670","31029","Chase County, Nebraska",1514,106,1333,107,1069,116,48,27,1285,108,264,80,181,69
"1671","31031","Cherry County, Nebraska",2149,160,1855,147,1622,161,76,34,1779,149,233,77,294,90
"1672","31033","Cheyenne County, Nebraska",4283,133,3914,165,3217,201,222,66,3692,172,697,153,369,92
"1673","31035","Clay County, Nebraska",2429,75,2253,91,1898,86,122,28,2131,91,355,59,176,38
"1674","31037","Colfax County, Nebraska",3582,128,3341,148,2007,221,240,175,3101,214,1334,240,241,72
"1675","31039","Cuming County, Nebraska",3704,133,3260,133,2594,156,239,65,3021,150,666,132,444,97
"1676","31041","Custer County, Nebraska",4508,131,3974,147,3272,150,267,75,3707,152,702,101,534,80
"1677","31043","Dakota County, Nebraska",7221,193,6514,233,4852,316,104,62,6410,239,1662,248,707,160
"1678","31045","Dawes County, Nebraska",3384,215,3129,232,2577,251,198,85,2931,228,552,203,255,81
"1679","31047","Dawson County, Nebraska",8799,157,7951,227,5859,269,408,112,7543,244,2092,268,848,175
"1680","31049","Deuel County, Nebraska",773,64,701,68,581,66,46,30,655,61,120,35,72,24
"1681","31051","Dixon County, Nebraska",2233,80,1994,93,1417,112,156,46,1838,83,577,91,239,55
"1682","31053","Dodge County, Nebraska",14639,271,13419,335,10831,383,725,145,12694,343,2588,330,1220,227
"1683","31055","Douglas County, Nebraska",227978,965,213545,1266,184155,1535,8565,548,204980,1298,29390,1285,14433,945
"1684","31057","Dundy County, Nebraska",826,72,712,74,554,81,73,35,639,72,158,45,114,40
"1685","31059","Fillmore County, Nebraska",2358,90,2035,114,1760,109,93,30,1942,111,275,62,323,65
"1686","31061","Franklin County, Nebraska",1210,61,1038,74,773,74,95,29,943,71,265,53,172,37
"1687","31063","Frontier County, Nebraska",1010,76,879,77,691,70,100,36,779,72,188,53,131,36
"1688","31065","Furnas County, Nebraska",1990,78,1700,94,1315,92,116,34,1584,99,385,83,290,63
"1689","31067","Gage County, Nebraska",9064,266,7845,309,6568,330,563,103,7282,298,1277,217,1219,223
"1690","31069","Garden County, Nebraska",866,79,793,81,627,80,57,22,736,85,166,52,73,33
"1691","31071","Garfield County, Nebraska",797,61,652,71,572,82,22,18,630,71,80,33,145,42
"1692","31073","Gosper County, Nebraska",759,79,694,82,573,82,30,14,664,79,121,39,65,25
"1693","31075","Grant County, Nebraska",305,46,271,44,226,35,10,7,261,42,45,26,34,16
"1694","31077","Greeley County, Nebraska",914,57,792,63,629,56,81,23,711,60,163,42,122,28
"1695","31079","Hall County, Nebraska",23724,250,21835,411,16727,542,935,179,20900,398,5108,469,1889,317
"1696","31081","Hamilton County, Nebraska",3567,156,3320,158,2898,141,179,93,3141,155,422,94,247,75
"1697","31083","Harlan County, Nebraska",1220,99,1117,97,900,88,92,27,1025,95,217,45,103,30
"1698","31085","Hayes County, Nebraska",354,47,328,45,245,43,14,16,314,44,83,29,26,13
"1699","31087","Hitchcock County, Nebraska",1094,91,899,84,708,70,85,30,814,80,191,52,195,58
"1700","31089","Holt County, Nebraska",4040,143,3601,148,2998,156,231,62,3370,149,603,116,439,96
"1701","31091","Hooker County, Nebraska",304,43,247,42,197,44,23,17,224,47,50,23,57,28
"1702","31093","Howard County, Nebraska",2538,106,2227,126,1762,115,151,54,2076,120,465,79,311,75
"1703","31095","Jefferson County, Nebraska",3131,120,2747,125,2244,133,233,64,2514,127,503,104,384,84
"1704","31097","Johnson County, Nebraska",1746,103,1538,109,1235,109,96,28,1442,108,303,56,208,49
"1705","31099","Kearney County, Nebraska",2721,94,2480,106,1952,140,174,66,2306,115,528,118,241,81
"1706","31101","Keith County, Nebraska",3749,176,3234,190,2605,204,260,89,2974,185,629,146,515,134
"1707","31103","Keya Paha County, Nebraska",330,46,282,43,236,38,17,10,265,42,46,20,48,19
"1708","31105","Kimball County, Nebraska",1479,103,1306,107,1061,106,114,43,1192,103,245,85,173,60
"1709","31107","Knox County, Nebraska",3323,114,2896,117,2264,118,232,44,2664,118,632,90,427,53
"1710","31109","Lancaster County, Nebraska",127779,758,121834,905,107225,1277,4913,364,116921,945,14609,894,5945,549
"1711","31111","Lincoln County, Nebraska",14439,358,13317,386,10250,410,777,195,12540,380,3067,369,1122,251
"1712","31113","Logan County, Nebraska",320,36,302,36,248,35,24,12,278,35,54,20,18,9
"1713","31115","Loup County, Nebraska",264,38,236,37,177,31,21,15,215,35,59,26,28,17
"1714","31117","McPherson County, Nebraska",201,31,188,32,157,31,33,16,155,33,31,19,13,9
"1715","31119","Madison County, Nebraska",13979,221,12743,292,10167,372,838,236,11905,357,2576,263,1236,195
"1716","31121","Merrick County, Nebraska",3136,121,2775,134,2174,155,175,64,2600,139,601,113,361,81
"1717","31123","Morrill County, Nebraska",1855,87,1639,98,1263,109,155,48,1484,103,376,88,216,55
"1718","31125","Nance County, Nebraska",1300,73,1149,71,942,76,76,28,1073,76,207,56,151,40
"1719","31127","Nemaha County, Nebraska",2794,163,2504,164,2182,170,197,53,2307,168,322,97,290,84
"1720","31129","Nuckolls County, Nebraska",1720,99,1479,93,1148,98,137,46,1342,91,331,71,241,56
"1721","31131","Otoe County, Nebraska",6312,160,5823,183,4844,198,392,104,5431,193,979,164,489,93
"1722","31133","Pawnee County, Nebraska",1069,73,809,81,659,72,41,22,768,82,150,41,260,61
"1723","31135","Perkins County, Nebraska",1137,63,1048,66,849,72,93,38,955,63,199,52,89,31
"1724","31137","Phelps County, Nebraska",3785,106,3442,149,2720,145,226,91,3216,165,722,145,343,107
"1725","31139","Pierce County, Nebraska",2861,77,2562,84,2075,125,208,65,2354,96,487,100,299,64
"1726","31141","Platte County, Nebraska",13306,188,12084,245,9761,328,782,184,11302,326,2323,259,1222,201
"1727","31143","Polk County, Nebraska",1958,93,1779,93,1459,106,122,28,1657,95,320,73,179,49
"1728","31145","Red Willow County, Nebraska",4328,206,3950,206,3248,237,182,74,3768,219,702,170,378,96
"1729","31147","Richardson County, Nebraska",3634,145,3029,193,2541,179,367,105,2662,191,488,95,605,143
"1730","31149","Rock County, Nebraska",559,51,505,55,456,54,21,9,484,56,49,19,54,19
"1731","31151","Saline County, Nebraska",5114,154,4651,195,3848,220,175,45,4476,197,803,153,463,115
"1732","31153","Sarpy County, Nebraska",69388,392,67073,481,60989,720,2010,253,65063,520,6084,542,2315,229
"1733","31155","Saunders County, Nebraska",8664,210,7921,236,6813,235,535,131,7386,255,1108,181,743,113
"1734","31157","Scotts Bluff County, Nebraska",14832,302,13283,333,10593,362,968,200,12315,341,2690,273,1549,236
"1735","31159","Seward County, Nebraska",6555,162,5949,187,5209,198,281,60,5668,189,740,129,606,91
"1736","31161","Sheridan County, Nebraska",2086,115,1830,134,1475,125,160,55,1670,126,355,81,256,56
"1737","31163","Sherman County, Nebraska",1322,84,1099,94,850,100,92,44,1007,83,249,53,223,55
"1738","31165","Sioux County, Nebraska",459,58,403,57,302,47,40,20,363,60,101,45,56,23
"1739","31167","Stanton County, Nebraska",2214,70,1999,80,1670,111,226,87,1773,105,329,103,215,60
"1740","31169","Thayer County, Nebraska",2056,74,1807,79,1448,92,153,51,1654,84,359,72,249,46
"1741","31171","Thomas County, Nebraska",283,34,263,36,221,36,1,2,262,36,42,21,20,14
"1742","31173","Thurston County, Nebraska",2026,40,1801,52,1265,66,89,30,1712,57,536,55,225,42
"1743","31175","Valley County, Nebraska",1725,80,1488,90,1185,86,67,23,1421,93,303,71,237,66
"1744","31177","Washington County, Nebraska",8290,127,7857,173,6841,225,438,120,7419,214,1016,210,433,121
"1745","31179","Wayne County, Nebraska",3714,186,3393,201,3079,216,135,68,3258,196,314,110,321,124
"1746","31181","Webster County, Nebraska",1434,66,1311,72,1066,74,111,27,1200,71,245,53,123,29
"1747","31183","Wheeler County, Nebraska",337,49,283,46,221,41,23,11,260,44,62,24,54,29
"1748","31185","York County, Nebraska",5597,216,5109,226,4467,246,369,106,4740,248,642,146,488,88
"1749","32001","Churchill County, Nevada",9753,299,9166,317,7796,405,565,152,8601,323,1370,268,587,164
"1750","32003","Clark County, Nevada",816296,2377,773608,2688,654877,3627,27980,1387,745628,3171,118731,2629,42688,1571
"1751","32005","Douglas County, Nevada",20911,324,19825,398,17899,373,1130,220,18695,428,1926,258,1086,253
"1752","32007","Elko County, Nevada",18614,357,17553,374,14388,554,959,309,16594,433,3165,485,1061,204
"1753","32009","Esmeralda County, Nevada",484,121,446,121,385,110,79,42,367,116,61,36,38,23
"1754","32011","Eureka County, Nevada",555,95,501,111,420,104,29,39,472,107,81,51,54,41
"1755","32013","Humboldt County, Nevada",6804,209,6345,261,4916,350,291,114,6054,295,1429,327,459,175
"1756","32015","Lander County, Nevada",2298,207,2185,198,1717,215,80,82,2105,186,468,181,113,76
"1757","32017","Lincoln County, Nevada",1728,189,1571,164,1250,187,175,101,1396,145,321,134,157,107
"1758","32019","Lyon County, Nevada",22342,286,21247,370,17730,643,1187,213,20060,383,3517,506,1095,214
"1759","32021","Mineral County, Nevada",1737,195,1504,200,1271,224,129,80,1375,194,233,91,233,84
"1760","32023","Nye County, Nevada",21411,613,19481,589,15450,721,1412,318,18069,642,4031,536,1930,368
"1761","32027","Pershing County, Nevada",1857,165,1689,182,1249,178,131,68,1558,198,440,161,168,119
"1762","32029","Storey County, Nevada",1611,194,1536,195,1355,172,74,52,1462,204,181,105,75,64
"1763","32031","Washoe County, Nevada",188878,1031,180379,1182,158278,1742,7357,649,173022,1361,22101,1269,8499,655
"1764","32033","White Pine County, Nevada",3482,423,3026,414,2253,351,220,96,2806,413,773,217,456,131
"1765","32510","Carson City, Nevada",23191,421,21370,444,18073,569,1213,190,20157,470,3297,452,1821,283
"1766","33001","Belknap County, New Hampshire",25571,656,23867,616,21134,646,1639,260,22228,666,2733,416,1704,285
"1767","33003","Carroll County, New Hampshire",21521,639,20368,696,18083,674,1607,308,18761,725,2285,325,1153,252
"1768","33005","Cheshire County, New Hampshire",29991,513,27617,569,23874,617,2100,326,25517,570,3743,377,2374,319
"1769","33007","Coos County, New Hampshire",13592,355,12153,355,10320,365,1129,150,11024,371,1833,250,1439,205
"1770","33009","Grafton County, New Hampshire",34357,620,31812,655,29116,638,2720,329,29092,707,2696,382,2545,417
"1771","33011","Hillsborough County, New Hampshire",165309,768,157131,1032,140069,1471,7553,599,149578,1209,17062,1175,8178,745
"1772","33013","Merrimack County, New Hampshire",59175,627,55401,718,49389,781,3344,403,52057,768,6012,525,3774,469
"1773","33015","Rockingham County, New Hampshire",124080,744,119246,845,109890,1228,5277,451,113969,914,9356,769,4834,495
"1774","33017","Strafford County, New Hampshire",50630,618,47921,713,43132,867,2289,414,45632,807,4789,590,2709,448
"1775","33019","Sullivan County, New Hampshire",16272,449,14927,481,12997,523,1021,228,13906,504,1930,320,1345,268
"1776","34001","Atlantic County, New Jersey",105277,840,98232,906,82665,1206,4728,536,93504,1035,15567,1133,7045,587
"1777","34003","Bergen County, New Jersey",348674,1210,330904,1636,301401,2064,11915,907,318989,1856,29503,1342,17770,1080
"1778","34005","Burlington County, New Jersey",172400,1182,163862,1282,148269,1624,6808,573,157054,1313,15593,1153,8538,719
"1779","34007","Camden County, New Jersey",196939,1149,183053,1297,156228,1610,8337,664,174716,1291,26825,1323,13886,1017
"1780","34009","Cape May County, New Jersey",41971,768,39474,760,34567,803,2208,332,37266,821,4907,433,2497,332
"1781","34011","Cumberland County, New Jersey",51873,968,47323,1051,37033,1063,2511,337,44812,1099,10290,894,4550,497
"1782","34013","Essex County, New Jersey",307613,1167,284531,1574,230169,2105,9931,747,274600,1795,54362,1904,23082,1042
"1783","34015","Gloucester County, New Jersey",109290,784,103603,925,92946,1145,4978,484,98625,1030,10657,894,5687,521
"1784","34017","Hudson County, New Jersey",282832,1261,265998,1530,229256,2326,6254,652,259744,1530,36742,1743,16834,1003
"1785","34019","Hunterdon County, New Jersey",48975,400,46849,486,43945,493,1994,241,44855,556,2904,307,2126,325
"1786","34021","Mercer County, New Jersey",137114,926,127900,1124,109410,1260,5526,537,122374,1170,18490,1091,9214,910
"1787","34023","Middlesex County, New Jersey",299455,1185,283181,1598,253657,1925,10291,782,272890,1689,29524,1517,16274,1074
"1788","34025","Monmouth County, New Jersey",245569,1175,233085,1352,212034,1654,9564,701,223521,1509,21051,1332,12484,760
"1789","34027","Morris County, New Jersey",187430,919,179410,1138,167099,1380,7084,652,172326,1039,12311,891,8020,682
"1790","34029","Ocean County, New Jersey",237729,1634,217003,2011,194249,2204,18447,1001,198556,1904,22754,1204,20726,1155
"1791","34031","Passaic County, New Jersey",176203,641,162946,1108,134515,1608,4974,448,157972,1057,28431,1268,13257,930
"1792","34033","Salem County, New Jersey",24753,379,22572,476,18838,485,1001,187,21571,501,3734,381,2181,285
"1793","34035","Somerset County, New Jersey",125363,697,121042,851,113013,1033,3924,469,117118,964,8029,777,4321,490
"1794","34037","Sussex County, New Jersey",55401,647,53000,693,48838,721,2180,271,50820,661,4162,464,2401,332
"1795","34039","Union County, New Jersey",198506,846,184918,1301,159701,1461,6692,577,178226,1359,25217,1225,13588,1001
"1796","34041","Warren County, New Jersey",43789,435,40528,554,35673,713,2381,348,38147,607,4855,533,3261,431
"1797","35001","Bernalillo County, New Mexico",277653,1311,259064,1719,216890,2141,11329,828,247735,1785,42174,1839,18589,1122
"1798","35003","Catron County, New Mexico",1523,164,1243,148,1167,151,289,114,954,146,76,51,280,127
"1799","35005","Chaves County, New Mexico",23244,509,20132,625,15101,638,1114,273,19018,680,5031,536,3112,376
"1800","35006","Cibola County, New Mexico",7934,323,6518,375,4532,414,563,234,5955,454,1986,371,1416,223
"1801","35007","Colfax County, New Mexico",5638,268,4780,291,3633,293,292,94,4488,286,1147,154,858,178
"1802","35009","Curry County, New Mexico",18285,391,16632,428,12807,534,532,146,16100,434,3825,410,1653,286
"1803","35011","De Baca County, New Mexico",580,120,482,103,356,95,80,81,402,93,126,55,98,66
"1804","35013","Doña Ana County, New Mexico",79933,913,72648,1129,58184,1187,2662,414,69986,1098,14464,1024,7285,625
"1805","35015","Eddy County, New Mexico",22315,506,20240,664,15737,755,900,198,19340,654,4503,619,2075,414
"1806","35017","Grant County, New Mexico",11144,432,9542,479,7649,387,708,184,8834,505,1893,410,1602,315
"1807","35019","Guadalupe County, New Mexico",1146,190,826,149,485,125,24,17,802,143,341,111,320,96
"1808","35021","Harding County, New Mexico",202,56,144,41,116,34,12,8,132,39,28,17,58,29
"1809","35023","Hidalgo County, New Mexico",1573,119,1314,127,949,126,53,32,1261,129,365,90,259,68
"1810","35025","Lea County, New Mexico",23851,467,21567,567,15031,712,562,161,21005,564,6536,762,2284,373
"1811","35027","Lincoln County, New Mexico",8723,479,8077,495,6216,465,342,134,7735,525,1861,385,646,196
"1812","35028","Los Alamos County, New Mexico",8029,177,7733,213,7217,237,242,79,7491,228,516,175,296,113
"1813","35029","Luna County, New Mexico",9047,307,7211,353,4552,475,253,104,6958,359,2659,477,1836,276
"1814","35031","McKinley County, New Mexico",20769,248,14757,424,10072,400,708,168,14049,459,4685,373,6012,383
"1815","35033","Mora County, New Mexico",2129,193,1386,188,910,146,145,72,1241,200,476,168,743,206
"1816","35035","Otero County, New Mexico",23590,644,21514,688,17254,681,1249,268,20265,707,4260,533,2076,308
"1817","35037","Quay County, New Mexico",3359,222,2746,280,2157,249,188,70,2558,279,589,150,613,165
"1818","35039","Rio Arriba County, New Mexico",13293,506,9974,510,7596,494,295,90,9679,504,2378,275,3319,409
"1819","35041","Roosevelt County, New Mexico",6895,290,6142,323,5042,320,402,136,5740,333,1100,218,753,190
"1820","35043","Sandoval County, New Mexico",53567,462,49400,637,43673,740,2396,316,47004,629,5727,583,4167,461
"1821","35045","San Juan County, New Mexico",40639,661,35206,750,25927,912,1770,255,33436,717,9279,700,5433,433
"1822","35047","San Miguel County, New Mexico",11451,380,8999,476,6959,498,577,156,8422,461,2040,324,2452,308
"1823","35049","Santa Fe County, New Mexico",65856,694,59672,773,52293,902,3013,410,56659,815,7379,550,6184,643
"1824","35051","Sierra County, New Mexico",5321,318,4418,377,3335,347,301,107,4117,365,1083,219,903,238
"1825","35053","Socorro County, New Mexico",4834,275,3520,295,2934,323,523,169,2997,245,586,171,1314,256
"1826","35055","Taos County, New Mexico",12840,512,11431,548,10039,570,719,230,10712,550,1392,290,1409,263
"1827","35057","Torrance County, New Mexico",5406,253,4701,343,3581,343,303,102,4398,338,1120,235,705,210
"1828","35059","Union County, New Mexico",1277,120,962,128,748,124,46,30,916,128,214,71,315,84
"1829","35061","Valencia County, New Mexico",25550,614,22454,673,17976,616,1553,266,20901,659,4478,545,3096,489
"1830","36001","Albany County, New York",130754,1085,121437,1259,106208,1701,6809,639,114628,1428,15229,1134,9317,841
"1831","36003","Allegany County, New York",16671,314,14616,344,12035,387,1306,124,13310,363,2581,259,2055,207
"1832","36005","Bronx County, New York",521340,1242,473839,2226,336714,3797,15361,1133,458478,2146,137125,3858,47501,1841
"1833","36007","Broome County, New York",81031,786,73106,1043,61888,1114,5105,529,68001,1166,11218,811,7925,740
"1834","36009","Cattaraugus County, New York",31333,428,26862,511,20959,511,2357,265,24505,568,5903,360,4471,329
"1835","36011","Cayuga County, New York",30604,484,27417,568,22493,649,1961,321,25456,580,4924,461,3187,325
"1836","36013","Chautauqua County, New York",53050,598,46539,754,38019,813,3786,394,42753,761,8520,553,6511,532
"1837","36015","Chemung County, New York",34223,587,31055,621,25006,767,1872,298,29183,665,6049,555,3168,420
"1838","36017","Chenango County, New York",19753,330,17734,339,14305,487,1527,194,16207,346,3429,376,2019,187
"1839","36019","Clinton County, New York",32379,500,29540,621,25865,617,1987,268,27553,692,3675,442,2839,382
"1840","36021","Columbia County, New York",25167,525,22824,542,19806,535,1392,224,21432,585,3018,321,2343,311
"1841","36023","Cortland County, New York",18260,405,16773,439,14749,430,986,155,15787,437,2024,262,1487,277
"1842","36025","Delaware County, New York",18487,561,16255,551,13267,555,1579,204,14676,584,2988,388,2232,298
"1843","36027","Dutchess County, New York",111735,796,105184,958,93510,1156,5811,517,99373,992,11674,784,6551,546
"1844","36029","Erie County, New York",403064,1528,366375,1979,305923,2824,21654,1162,344721,2014,60452,2389,36689,1277
"1845","36031","Essex County, New York",15714,401,14221,471,12406,471,1212,216,13009,477,1815,234,1493,249
"1846","36033","Franklin County, New York",18561,427,16385,500,13061,530,1549,254,14836,449,3324,372,2176,334
"1847","36035","Fulton County, New York",21712,455,19367,521,14185,623,1443,265,17924,543,5182,522,2345,311
"1848","36037","Genesee County, New York",24461,283,22282,437,18918,532,1601,244,20681,456,3364,370,2179,331
"1849","36039","Greene County, New York",17451,489,15214,570,12784,551,1202,241,14012,536,2430,331,2237,318
"1850","36041","Hamilton County, New York",1457,137,1300,133,837,93,124,40,1176,132,463,98,157,51
"1851","36043","Herkimer County, New York",24441,445,21848,509,18029,553,2021,294,19827,459,3819,376,2593,304
"1852","36045","Jefferson County, New York",45517,803,42327,849,36350,953,2485,345,39842,822,5977,519,3190,352
"1853","36047","Kings County, New York",985108,2352,890670,3348,764432,4029,33146,1466,857524,3285,126238,2798,94438,2183
"1854","36049","Lewis County, New York",10453,289,9229,308,7676,296,721,113,8508,315,1553,196,1224,147
"1855","36051","Livingston County, New York",24012,402,21958,495,19282,565,1346,245,20612,518,2676,301,2054,287
"1856","36053","Madison County, New York",24779,528,22246,586,19658,654,1530,211,20716,611,2588,301,2533,336
"1857","36055","Monroe County, New York",311955,1303,287954,1603,244967,2290,14631,788,273323,1752,42987,1757,24001,1105
"1858","36057","Montgomery County, New York",18907,389,16294,433,13196,441,1062,171,15232,443,3098,360,2613,306
"1859","36059","Nassau County, New York",453576,1375,430824,1726,394462,2372,15861,841,414963,1735,36362,1592,22752,1138
"1860","36061","New York County, New York",767213,4386,716237,4425,641445,5392,23818,1730,692419,4758,74792,3335,50976,2056
"1861","36063","Niagara County, New York",90030,707,80869,901,67909,1111,5135,446,75734,955,12960,756,9161,668
"1862","36065","Oneida County, New York",90866,820,82036,885,67781,1101,4987,387,77049,921,14255,928,8830,603
"1863","36067","Onondaga County, New York",190353,1221,173443,1383,149225,1428,9710,591,163733,1460,24218,1282,16910,815
"1864","36069","Ontario County, New York",46547,550,43115,639,38108,717,2582,375,40533,675,5007,540,3432,378
"1865","36071","Orange County, New York",132880,858,120587,1242,105164,1460,5865,550,114722,1199,15423,861,12293,908
"1866","36073","Orleans County, New York",16203,352,14184,456,11540,514,858,154,13326,477,2644,381,2019,318
"1867","36075","Oswego County, New York",46749,625,43204,627,35983,713,2657,368,40547,652,7221,504,3545,407
"1868","36077","Otsego County, New York",22448,515,20254,560,17356,576,1885,240,18369,578,2898,334,2194,204
"1869","36079","Putnam County, New York",34651,501,33105,630,30329,634,1665,306,31440,697,2776,350,1546,336
"1870","36081","Queens County, New York",807468,2634,753237,3222,633222,4511,27266,1489,725971,3557,120015,2964,54231,1862
"1871","36083","Rensselaer County, New York",66341,689,61693,814,53397,970,3871,492,57822,850,8296,663,4648,385
"1872","36085","Richmond County, New York",169528,839,157396,1227,138533,1475,7091,576,150305,1442,18863,1128,12132,963
"1873","36087","Rockland County, New York",102161,653,92506,973,83049,1046,6306,583,86200,966,9457,770,9655,753
"1874","36089","St. Lawrence County, New York",41224,506,36773,627,29564,811,2434,319,34339,650,7209,636,4451,374
"1875","36091","Saratoga County, New York",97829,873,92165,1078,82254,1397,4820,574,87345,1074,9911,854,5664,500
"1876","36093","Schenectady County, New York",61038,676,56984,845,47859,933,3573,383,53411,945,9125,770,4054,442
"1877","36095","Schoharie County, New York",12110,295,10700,327,8794,346,898,167,9802,346,1906,236,1410,180
"1878","36097","Schuyler County, New York",7542,258,6768,268,5656,302,499,95,6269,268,1112,177,774,134
"1879","36099","Seneca County, New York",13603,281,12319,339,10287,416,875,153,11444,357,2032,307,1284,174
"1880","36101","Steuben County, New York",38650,401,34648,519,29114,602,2565,273,32083,590,5534,454,4002,348
"1881","36103","Suffolk County, New York",505564,1727,478901,1955,438494,2393,21956,1012,456945,2237,40407,1712,26663,1320
"1882","36105","Sullivan County, New York",28816,727,25911,790,21710,813,2075,287,23836,786,4201,460,2905,420
"1883","36107","Tioga County, New York",20316,310,18496,381,16178,436,1466,237,17030,426,2318,304,1820,225
"1884","36109","Tompkins County, New York",42889,595,40878,623,37319,835,2221,305,38657,647,3559,568,2011,331
"1885","36111","Ulster County, New York",71194,816,66454,790,57656,1066,4536,563,61918,897,8798,830,4740,553
"1886","36113","Warren County, New York",29261,465,26449,605,22926,648,2021,320,24428,620,3523,354,2812,426
"1887","36115","Washington County, New York",24073,375,21847,416,17538,584,1635,222,20212,425,4309,498,2226,286
"1888","36117","Wayne County, New York",37771,444,34474,463,29117,582,2545,339,31929,497,5357,458,3297,387
"1889","36119","Westchester County, New York",364413,1415,342921,1898,302935,2286,12947,997,329974,2066,39986,1659,21492,1313
"1890","36121","Wyoming County, New York",15870,378,14123,380,11784,350,1234,224,12889,411,2339,261,1747,197
"1891","36123","Yates County, New York",8594,310,6873,307,5986,300,444,104,6429,305,887,142,1721,240
"1892","37001","Alamance County, North Carolina",66311,633,60882,743,49610,946,2734,390,58148,832,11272,774,5429,500
"1893","37003","Alexander County, North Carolina",13496,390,11843,502,9628,497,881,222,10962,504,2215,373,1653,280
"1894","37005","Alleghany County, North Carolina",4772,275,4085,258,3212,233,290,103,3795,257,873,196,687,144
"1895","37007","Anson County, North Carolina",8381,273,7262,319,5282,340,368,150,6894,339,1980,270,1119,220
"1896","37009","Ashe County, North Carolina",11723,504,10048,525,8190,533,743,154,9305,542,1858,321,1675,266
"1897","37011","Avery County, North Carolina",6378,437,5630,416,4338,388,357,107,5273,420,1292,239,748,142
"1898","37013","Beaufort County, North Carolina",18579,470,16190,496,13251,567,995,172,15195,489,2939,374,2389,374
"1899","37015","Bertie County, North Carolina",7188,345,5827,394,4220,373,333,136,5494,402,1607,317,1361,244
"1900","37017","Bladen County, North Carolina",11492,368,9855,442,7298,462,525,164,9330,449,2557,403,1637,375
"1901","37019","Brunswick County, North Carolina",57812,874,54973,922,47696,984,2692,362,52281,948,7277,683,2839,345
"1902","37021","Buncombe County, North Carolina",103575,1484,92512,1601,78897,1913,4207,589,88305,1570,13615,1094,11063,1050
"1903","37023","Burke County, North Carolina",34376,529,29770,677,22984,807,1903,271,27867,740,6786,559,4606,453
"1904","37025","Cabarrus County, North Carolina",74967,897,71367,940,62308,1168,2470,386,68897,1053,9059,809,3600,453
"1905","37027","Caldwell County, North Carolina",31840,558,27180,705,21281,730,1545,255,25635,739,5899,557,4660,556
"1906","37029","Camden County, North Carolina",3792,145,3486,174,3081,204,124,74,3362,171,405,130,306,115
"1907","37031","Carteret County, North Carolina",30069,537,28317,556,24412,593,1354,218,26963,601,3905,377,1752,255
"1908","37033","Caswell County, North Carolina",8595,321,7291,360,5800,382,475,141,6816,387,1491,307,1304,248
"1909","37035","Catawba County, North Carolina",63386,595,57590,762,45676,967,2284,350,55306,870,11914,868,5796,508
"1910","37037","Chatham County, North Carolina",30128,487,27778,590,23934,691,1565,261,26213,587,3844,468,2350,440
"1911","37039","Cherokee County, North Carolina",12371,492,11001,474,9036,515,911,188,10090,476,1965,336,1370,211
"1912","37041","Chowan County, North Carolina",6270,244,5458,308,3696,393,405,168,5053,349,1762,347,812,209
"1913","37043","Clay County, North Carolina",5152,337,4449,351,3422,359,259,105,4190,372,1027,263,703,194
"1914","37045","Cleveland County, North Carolina",36665,591,31224,768,24259,787,1752,254,29472,757,6965,602,5441,536
"1915","37047","Columbus County, North Carolina",19230,472,16400,587,11466,638,925,211,15475,607,4934,480,2830,354
"1916","37049","Craven County, North Carolina",40420,703,36713,811,30188,921,1743,244,34970,796,6525,693,3707,534
"1917","37051","Cumberland County, North Carolina",125158,886,115228,1020,95693,1114,4273,381,110955,1126,19535,801,9930,649
"1918","37053","Currituck County, North Carolina",10702,281,10253,288,8775,375,369,138,9884,321,1478,308,449,123
"1919","37055","Dare County, North Carolina",15832,592,15278,596,13532,624,601,177,14677,591,1746,276,554,157
"1920","37057","Davidson County, North Carolina",66986,745,61389,847,49725,1132,3125,401,58264,928,11664,1127,5597,528
"1921","37059","Davie County, North Carolina",16319,435,15227,490,12816,565,751,191,14476,511,2411,455,1092,240
"1922","37061","Duplin County, North Carolina",19827,548,16766,629,11600,690,744,182,16022,626,5166,588,3061,386
"1923","37063","Durham County, North Carolina",132762,884,126312,1144,110317,1469,4101,585,122211,1116,15995,1100,6450,747
"1924","37065","Edgecombe County, North Carolina",19259,481,15676,607,11595,582,860,198,14816,604,4081,493,3583,385
"1925","37067","Forsyth County, North Carolina",150651,1317,140435,1452,116677,1429,5642,456,134793,1511,23758,1168,10216,705
"1926","37069","Franklin County, North Carolina",25473,523,22780,598,18391,725,929,216,21851,586,4389,522,2693,414
"1927","37071","Gaston County, North Carolina",88710,654,80824,786,65303,1005,3421,386,77403,848,15521,946,7886,558
"1928","37073","Gates County, North Carolina",4139,168,3571,225,2944,226,156,81,3415,232,627,182,568,155
"1929","37075","Graham County, North Carolina",3150,203,2491,230,1850,201,213,92,2278,233,641,153,659,142
"1930","37077","Granville County, North Carolina",21132,518,19477,518,16004,604,1128,273,18349,549,3473,444,1655,281
"1931","37079","Greene County, North Carolina",6779,208,5929,225,4132,285,267,101,5662,236,1797,244,850,162
"1932","37081","Guilford County, North Carolina",209602,1462,191495,1880,164095,1905,8255,866,183240,2062,27400,1399,18107,1219
"1933","37083","Halifax County, North Carolina",20049,441,16536,510,11672,590,1066,236,15470,539,4864,493,3513,373
"1934","37085","Harnett County, North Carolina",47075,523,43459,749,35763,835,1363,245,42096,744,7696,682,3616,400
"1935","37087","Haywood County, North Carolina",26399,716,23292,795,17633,808,1139,226,22153,813,5659,554,3107,383
"1936","37089","Henderson County, North Carolina",48519,701,45009,809,38196,817,2029,294,42980,797,6813,647,3510,435
"1937","37091","Hertford County, North Carolina",8243,240,7009,327,5256,326,575,113,6434,334,1753,269,1234,206
"1938","37093","Hoke County, North Carolina",17705,335,15629,358,13109,472,577,171,15052,376,2520,404,2076,260
"1939","37095","Hyde County, North Carolina",2000,175,1674,180,1261,155,88,76,1586,166,413,177,326,154
"1940","37097","Iredell County, North Carolina",70654,633,66072,709,56240,918,2848,355,63224,810,9832,736,4582,457
"1941","37099","Jackson County, North Carolina",16901,672,15483,649,11907,699,681,183,14802,678,3576,598,1418,247
"1942","37101","Johnston County, North Carolina",76121,695,71078,830,60716,1150,2465,495,68613,855,10362,949,5043,581
"1943","37103","Jones County, North Carolina",3779,158,3121,166,2346,160,201,78,2920,183,775,120,658,115
"1944","37105","Lee County, North Carolina",23782,409,21816,497,17387,593,946,178,20870,496,4429,528,1966,357
"1945","37107","Lenoir County, North Carolina",22767,445,19780,485,14269,599,1100,223,18680,486,5511,547,2987,415
"1946","37109","Lincoln County, North Carolina",33863,469,30968,606,25741,712,986,246,29982,612,5227,617,2895,464
"1947","37111","McDowell County, North Carolina",18209,401,16259,496,12437,563,1113,329,15146,595,3822,426,1950,305
"1948","37113","Macon County, North Carolina",17161,624,14801,647,11721,535,1040,215,13761,680,3080,503,2360,352
"1949","37115","Madison County, North Carolina",8280,312,6903,373,5462,389,476,150,6427,384,1441,319,1377,266
"1950","37117","Martin County, North Carolina",9262,290,7972,333,6146,322,627,188,7345,346,1826,318,1290,203
"1951","37119","Mecklenburg County, North Carolina",435562,1569,417688,1775,367448,2317,10352,902,407336,1903,50240,1738,17874,1166
"1952","37121","Mitchell County, North Carolina",6438,300,5417,294,4242,302,440,131,4977,322,1175,217,1021,173
"1953","37123","Montgomery County, North Carolina",9112,409,7756,424,5529,403,536,164,7220,417,2227,347,1356,236
"1954","37125","Moore County, North Carolina",40595,633,37402,763,32491,815,2342,351,35060,850,4911,538,3193,397
"1955","37127","Nash County, North Carolina",37477,573,33419,752,26404,906,1842,334,31577,745,7015,787,4058,536
"1956","37129","New Hanover County, North Carolina",97852,1043,93512,1145,83074,1301,3107,446,90405,1280,10438,878,4340,558
"1957","37131","Northampton County, North Carolina",7397,265,5902,325,4278,326,517,187,5385,367,1624,300,1495,234
"1958","37133","Onslow County, North Carolina",69246,1259,66355,1346,57847,1468,1611,388,64744,1383,8508,967,2891,436
"1959","37135","Orange County, North Carolina",54783,849,52651,929,48374,1055,1459,232,51192,930,4277,526,2132,467
"1960","37137","Pamlico County, North Carolina",5120,250,4504,238,3724,215,292,89,4212,234,780,156,616,109
"1961","37139","Pasquotank County, North Carolina",15061,369,13557,448,10875,541,611,181,12946,431,2682,401,1504,238
"1962","37141","Pender County, North Carolina",22653,512,21005,486,17197,670,1059,197,19946,485,3808,519,1648,308
"1963","37143","Perquimans County, North Carolina",5733,217,4929,238,3997,232,343,111,4586,223,932,188,804,150
"1964","37145","Person County, North Carolina",15927,409,14334,503,11481,571,963,220,13371,555,2853,402,1593,275
"1965","37147","Pitt County, North Carolina",71134,733,65338,962,55472,1102,2303,368,63035,1008,9866,728,5796,602
"1966","37149","Polk County, North Carolina",8596,269,7879,275,6585,289,571,148,7308,275,1294,201,717,144
"1967","37151","Randolph County, North Carolina",55757,524,50442,821,39975,1110,2449,333,47993,879,10467,734,5315,640
"1968","37153","Richmond County, North Carolina",16292,489,13952,573,9989,548,824,197,13128,612,3963,421,2340,337
"1969","37155","Robeson County, North Carolina",42241,458,35852,558,23714,640,1459,201,34393,592,12138,489,6389,350
"1970","37157","Rockingham County, North Carolina",37926,562,31514,866,24555,867,2373,427,29141,910,6959,720,6412,720
"1971","37159","Rowan County, North Carolina",55485,700,49925,884,39239,1134,2322,433,47603,876,10686,898,5560,602
"1972","37161","Rutherford County, North Carolina",25925,531,22333,688,17371,754,1376,329,20957,716,4962,542,3592,490
"1973","37163","Sampson County, North Carolina",21281,477,18356,646,13893,548,861,182,17495,629,4463,441,2925,407
"1974","37165","Scotland County, North Carolina",12214,292,10187,333,7243,316,420,115,9767,334,2944,244,2027,232
"1975","37167","Stanly County, North Carolina",23633,438,21476,600,16823,541,1085,241,20391,654,4653,493,2157,370
"1976","37169","Stokes County, North Carolina",18777,367,16047,565,12860,652,1172,301,14875,617,3187,477,2730,470
"1977","37171","Surry County, North Carolina",28603,413,24579,528,19423,738,1572,211,23007,549,5156,572,4024,408
"1978","37173","Swain County, North Carolina",5505,291,4591,308,3297,299,246,100,4345,337,1294,225,914,165
"1979","37175","Transylvania County, North Carolina",14113,496,12859,528,10415,571,1015,310,11844,590,2444,348,1254,313
"1980","37177","Tyrrell County, North Carolina",1415,152,1189,156,921,152,55,38,1134,152,268,88,226,100
"1981","37179","Union County, North Carolina",78473,662,74910,747,65512,983,2114,288,72796,755,9398,844,3563,424
"1982","37181","Vance County, North Carolina",16063,397,14028,533,10530,625,737,194,13291,541,3498,386,2035,346
"1983","37183","Wake County, North Carolina",422144,1743,410411,1929,373976,2441,9453,699,400958,1990,36435,1945,11733,1115
"1984","37185","Warren County, North Carolina",7737,280,6297,335,4637,311,462,120,5835,364,1660,264,1440,243
"1985","37187","Washington County, North Carolina",4938,307,3718,342,2596,317,189,100,3529,347,1122,226,1220,247
"1986","37189","Watauga County, North Carolina",20805,562,19288,576,17124,693,675,171,18613,593,2164,395,1517,282
"1987","37191","Wayne County, North Carolina",46761,593,41863,727,33248,895,1983,325,39880,821,8615,770,4898,491
"1988","37193","Wilkes County, North Carolina",27265,568,23762,628,19194,721,2110,398,21652,674,4568,563,3503,472
"1989","37195","Wilson County, North Carolina",31980,508,26573,647,20684,689,1583,314,24990,651,5889,505,5407,544
"1990","37197","Yadkin County, North Carolina",14829,326,13033,355,10200,420,1154,208,11879,383,2833,305,1796,232
"1991","37199","Yancey County, North Carolina",7618,285,6398,329,5169,350,391,142,6007,333,1229,232,1220,226
"1992","38001","Adams County, North Dakota",999,70,862,74,705,80,108,51,754,62,157,50,137,49
"1993","38003","Barnes County, North Dakota",4833,171,4433,159,3671,226,332,117,4101,141,762,186,400,99
"1994","38005","Benson County, North Dakota",1899,76,1594,85,1158,82,127,38,1467,90,436,52,305,50
"1995","38007","Billings County, North Dakota",305,39,266,36,242,35,8,6,258,35,24,15,39,19
"1996","38009","Bottineau County, North Dakota",2586,132,2376,135,2122,146,204,69,2172,151,254,64,210,50
"1997","38011","Bowman County, North Dakota",1190,79,1110,84,937,75,75,35,1035,81,173,51,80,33
"1998","38013","Burke County, North Dakota",903,68,840,68,733,66,37,18,803,66,107,32,63,25
"1999","38015","Burleigh County, North Dakota",39323,436,36384,609,31413,670,1794,324,34590,617,4971,470,2939,414
"2000","38017","Cass County, North Dakota",77977,879,73885,1008,65256,1140,2251,322,71634,1076,8629,782,4092,559
"2001","38019","Cavalier County, North Dakota",1553,102,1377,98,1093,104,95,40,1282,97,284,69,176,54
"2002","38021","Dickey County, North Dakota",1945,110,1751,123,1442,125,109,36,1642,121,309,63,194,68
"2003","38023","Divide County, North Dakota",911,73,848,71,722,67,66,36,782,78,126,60,63,35
"2004","38025","Dunn County, North Dakota",1476,98,1383,95,1094,104,46,20,1337,93,289,61,93,34
"2005","38027","Eddy County, North Dakota",1053,85,871,78,723,79,81,32,790,76,148,39,182,53
"2006","38029","Emmons County, North Dakota",1507,75,1218,79,994,73,171,50,1047,71,224,47,289,57
"2007","38031","Foster County, North Dakota",1456,79,1260,88,1083,95,76,36,1184,86,177,45,196,66
"2008","38033","Golden Valley County, North Dakota",719,60,633,64,557,65,39,28,594,61,76,35,86,35
"2009","38035","Grand Forks County, North Dakota",30862,378,28657,474,25177,611,1235,240,27422,526,3480,476,2205,368
"2010","38037","Grant County, North Dakota",1056,63,871,58,793,60,108,27,763,63,78,20,185,37
"2011","38039","Griggs County, North Dakota",927,69,835,76,681,68,67,22,768,79,154,46,92,39
"2012","38041","Hettinger County, North Dakota",1037,80,894,76,731,72,60,21,834,73,163,44,143,38
"2013","38043","Kidder County, North Dakota",1042,88,878,76,757,75,120,42,758,74,121,43,164,57
"2014","38045","LaMoure County, North Dakota",1728,93,1538,95,1325,94,163,55,1375,92,213,52,190,39
"2015","38047","Logan County, North Dakota",772,62,684,64,567,59,70,29,614,64,117,32,88,25
"2016","38049","McHenry County, North Dakota",2329,93,2052,108,1737,102,141,50,1911,110,315,66,277,64
"2017","38051","McIntosh County, North Dakota",1224,74,1018,79,797,65,143,42,875,76,221,55,206,40
"2018","38053","McKenzie County, North Dakota",4928,293,4629,288,3962,281,38,26,4591,285,667,164,299,88
"2019","38055","McLean County, North Dakota",4101,137,3824,140,3247,142,228,58,3596,148,577,90,277,46
"2020","38057","Mercer County, North Dakota",3513,182,3160,191,2693,210,159,63,3001,196,467,110,353,100
"2021","38059","Morton County, North Dakota",13237,406,12307,448,10928,469,609,169,11698,483,1379,324,930,239
"2022","38061","Mountrail County, North Dakota",3472,143,3199,146,2530,147,153,51,3046,149,669,122,273,67
"2023","38063","Nelson County, North Dakota",1318,80,1178,79,954,82,102,27,1076,80,224,66,140,36
"2024","38065","Oliver County, North Dakota",687,77,623,77,477,63,47,22,576,75,146,60,64,25
"2025","38067","Pembina County, North Dakota",2941,113,2488,129,2054,124,209,56,2279,127,434,79,453,92
"2026","38069","Pierce County, North Dakota",1671,108,1457,103,1186,107,100,44,1357,100,271,67,214,69
"2027","38071","Ramsey County, North Dakota",4915,196,4327,249,3445,283,272,90,4055,251,882,192,588,186
"2028","38073","Ransom County, North Dakota",2305,89,1986,94,1673,92,161,72,1825,91,313,71,319,75
"2029","38075","Renville County, North Dakota",854,68,815,64,711,63,19,13,796,64,104,37,39,21
"2030","38077","Richland County, North Dakota",6668,179,6119,187,5067,206,393,92,5726,199,1052,164,549,96
"2031","38079","Rolette County, North Dakota",3693,106,3107,145,2213,146,180,64,2927,146,894,127,586,94
"2032","38081","Sargent County, North Dakota",1775,64,1655,62,1345,68,94,22,1561,66,310,45,120,35
"2033","38083","Sheridan County, North Dakota",624,56,523,51,452,45,82,31,441,50,71,26,101,33
"2034","38085","Sioux County, North Dakota",1061,33,825,54,577,50,59,21,766,53,248,47,236,45
"2035","38087","Slope County, North Dakota",319,38,277,37,242,33,25,16,252,36,35,17,42,16
"2036","38089","Stark County, North Dakota",13123,305,11912,310,9323,413,694,181,11218,344,2589,374,1211,211
"2037","38091","Steele County, North Dakota",776,79,655,75,552,73,36,16,619,74,103,32,121,39
"2038","38093","Stutsman County, North Dakota",9069,280,8334,297,6910,372,430,145,7904,298,1424,289,735,170
"2039","38095","Towner County, North Dakota",980,67,849,70,710,72,48,28,801,74,139,45,131,45
"2040","38097","Traill County, North Dakota",3276,120,3002,125,2447,146,142,55,2860,130,555,124,274,62
"2041","38099","Walsh County, North Dakota",4526,140,3875,171,3031,183,177,53,3698,169,844,112,651,117
"2042","38101","Ward County, North Dakota",27994,568,26298,609,22162,658,1036,249,25262,645,4136,469,1696,305
"2043","38103","Wells County, North Dakota",1818,105,1607,108,1318,99,132,63,1475,119,289,80,211,53
"2044","38105","Williams County, North Dakota",15286,710,14361,752,11690,729,532,184,13829,743,2671,590,925,256
"2045","39001","Adams County, Ohio",10163,350,8751,384,6686,400,821,185,7930,433,2065,294,1412,220
"2046","39003","Allen County, Ohio",40671,490,36854,558,29465,711,2039,260,34815,583,7389,587,3817,362
"2047","39005","Ashland County, Ohio",20531,333,18166,448,14616,508,1021,211,17145,444,3550,391,2365,319
"2048","39007","Ashtabula County, Ohio",38332,580,33848,675,26396,720,2190,298,31658,733,7452,581,4484,407
"2049","39009","Athens County, Ohio",22381,572,20280,687,17029,793,985,238,19295,693,3251,438,2101,410
"2050","39011","Auglaize County, Ohio",18872,229,17303,303,14718,381,1122,204,16181,330,2585,294,1569,262
"2051","39013","Belmont County, Ohio",25388,385,21418,469,17258,559,1740,249,19678,444,4160,377,3970,402
"2052","39015","Brown County, Ohio",16968,372,14733,484,11156,519,937,209,13796,498,3577,392,2235,378
"2053","39017","Butler County, Ohio",142881,897,134163,1012,114154,1462,4928,535,129235,1102,20009,1152,8718,633
"2054","39019","Carroll County, Ohio",11300,324,10013,376,7595,381,894,225,9119,364,2418,280,1287,254
"2055","39021","Champaign County, Ohio",15506,280,14418,304,11611,445,749,133,13669,352,2807,380,1088,171
"2056","39023","Clark County, Ohio",55124,639,50785,676,40580,797,2844,371,47941,687,10205,672,4339,338
"2057","39025","Clermont County, Ohio",81785,610,76574,710,66109,1063,3607,355,72967,696,10465,935,5211,514
"2058","39027","Clinton County, Ohio",16548,339,15211,369,12069,472,760,158,14451,377,3142,420,1337,206
"2059","39029","Columbiana County, Ohio",41313,497,36542,700,28027,796,2000,307,34542,717,8515,812,4771,571
"2060","39031","Coshocton County, Ohio",14517,326,12219,359,9117,355,701,125,11518,374,3102,350,2298,282
"2061","39033","Crawford County, Ohio",18028,297,16327,334,12605,462,1060,208,15267,427,3722,387,1701,194
"2062","39035","Cuyahoga County, Ohio",551267,1883,500616,2201,408176,2659,25318,1122,475298,2487,92440,2204,50651,1704
"2063","39037","Darke County, Ohio",20826,321,18378,455,15075,458,1488,253,16890,498,3303,328,2448,323
"2064","39039","Defiance County, Ohio",15075,234,13726,288,11350,378,789,188,12937,294,2376,298,1349,208
"2065","39041","Delaware County, Ohio",76549,558,74908,626,70065,832,2308,369,72600,776,4843,557,1641,271
"2066","39043","Erie County, Ohio",31984,549,29220,646,24082,711,1994,317,27226,670,5138,494,2764,368
"2067","39045","Fairfield County, Ohio",57841,544,53986,628,46583,756,2425,360,51561,668,7403,660,3855,417
"2068","39047","Fayette County, Ohio",11471,257,10367,299,7578,382,472,110,9895,285,2789,312,1104,203
"2069","39049","Franklin County, Ohio",537109,2218,511377,2437,434175,3393,16407,1157,494970,2561,77202,2108,25732,1404
"2070","39051","Fulton County, Ohio",16763,245,15464,323,13085,447,702,140,14762,330,2379,307,1299,218
"2071","39053","Gallia County, Ohio",11292,314,9362,399,7138,495,653,226,8709,383,2224,328,1930,248
"2072","39055","Geauga County, Ohio",35249,417,31822,424,28145,531,1407,235,30415,451,3677,436,3427,342
"2073","39057","Greene County, Ohio",66279,709,62542,804,55263,910,2563,330,59979,888,7279,626,3737,453
"2074","39059","Guernsey County, Ohio",16136,322,14172,449,10617,530,848,162,13324,419,3555,399,1964,336
"2075","39061","Hamilton County, Ohio",345878,1645,320711,1913,268117,2414,14831,935,305880,2151,52594,1785,25167,1232
"2076","39063","Hancock County, Ohio",31164,400,29198,495,24657,577,1849,402,27349,625,4541,438,1966,294
"2077","39065","Hardin County, Ohio",11557,293,10376,326,8158,430,843,167,9533,309,2218,289,1181,212
"2078","39067","Harrison County, Ohio",5748,181,4787,201,3793,233,779,216,4008,238,994,162,961,153
"2079","39069","Henry County, Ohio",11040,235,10127,246,8183,269,459,121,9668,254,1944,211,913,149
"2080","39071","Highland County, Ohio",16526,344,14190,421,10382,461,550,115,13640,444,3808,412,2336,305
"2081","39073","Hocking County, Ohio",11240,344,10196,360,8217,356,686,147,9510,374,1979,241,1044,190
"2082","39075","Holmes County, Ohio",13200,266,9064,411,7029,424,456,140,8608,411,2035,279,4136,360
"2083","39077","Huron County, Ohio",23288,365,21174,449,17337,509,1579,256,19595,480,3837,426,2114,264
"2084","39079","Jackson County, Ohio",12361,351,10747,407,7665,459,594,158,10153,433,3082,401,1614,275
"2085","39081","Jefferson County, Ohio",26776,400,22762,502,18268,559,1531,228,21231,499,4494,463,4014,316
"2086","39083","Knox County, Ohio",22908,481,20880,511,17446,583,1083,187,19797,500,3434,438,2028,249
"2087","39085","Lake County, Ohio",98217,685,91488,884,80188,1081,5149,457,86339,1031,11300,797,6729,596
"2088","39087","Lawrence County, Ohio",22608,461,19618,555,14650,618,1125,183,18493,577,4968,501,2990,368
"2089","39089","Licking County, Ohio",66342,619,62147,731,54566,934,3000,394,59147,729,7581,647,4195,488
"2090","39091","Logan County, Ohio",18928,394,17529,448,14541,454,684,130,16845,424,2988,338,1399,254
"2091","39093","Lorain County, Ohio",123500,782,114769,1026,97633,1329,6744,466,108025,1071,17136,980,8731,755
"2092","39095","Lucas County, Ohio",179358,1218,165085,1331,131535,1555,7799,771,157286,1382,33550,1524,14273,803
"2093","39097","Madison County, Ohio",15181,388,13916,413,11779,406,457,104,13459,425,2137,266,1265,223
"2094","39099","Mahoning County, Ohio",97293,739,87239,845,69622,1112,4678,469,82561,847,17617,868,10054,673
"2095","39101","Marion County, Ohio",24251,317,22125,382,17567,473,1454,289,20671,441,4558,424,2126,303
"2096","39103","Medina County, Ohio",71360,425,68117,523,61285,682,3043,387,65074,664,6832,548,3243,369
"2097","39105","Meigs County, Ohio",8719,252,7267,328,5377,339,510,133,6757,325,1890,265,1452,267
"2098","39107","Mercer County, Ohio",15923,247,14662,293,12548,331,1002,211,13660,339,2114,290,1261,195
"2099","39109","Miami County, Ohio",43279,490,40243,587,34639,751,2543,414,37700,710,5604,564,3036,344
"2100","39111","Monroe County, Ohio",5565,208,4648,230,3281,258,330,85,4318,252,1367,223,917,162
"2101","39113","Montgomery County, Ohio",226199,1319,208185,1611,170597,1781,10190,755,197995,1563,37588,1551,18014,1067
"2102","39115","Morgan County, Ohio",5629,222,4698,208,3402,205,435,97,4263,219,1296,210,931,154
"2103","39117","Morrow County, Ohio",13048,260,11965,300,9905,360,895,245,11070,358,2060,311,1083,200
"2104","39119","Muskingum County, Ohio",33970,433,29997,586,23554,670,1741,248,28256,591,6443,565,3973,420
"2105","39121","Noble County, Ohio",4608,225,3685,264,2865,281,525,200,3160,303,820,194,923,170
"2106","39123","Ottawa County, Ohio",17930,411,16536,410,13637,427,1290,222,15246,424,2899,311,1394,202
"2107","39125","Paulding County, Ohio",7480,185,6617,211,5200,219,468,95,6149,211,1417,176,863,122
"2108","39127","Perry County, Ohio",13071,318,11651,404,8752,401,626,184,11025,468,2899,385,1420,247
"2109","39129","Pickaway County, Ohio",20706,341,19001,414,15390,494,893,238,18108,475,3611,364,1705,238
"2110","39131","Pike County, Ohio",10478,334,9202,368,6520,422,486,180,8716,369,2682,352,1276,237
"2111","39133","Portage County, Ohio",63372,1062,58774,1121,50636,1301,3065,401,55709,1175,8138,764,4598,473
"2112","39135","Preble County, Ohio",16648,290,15010,330,12654,378,874,155,14136,365,2356,336,1638,218
"2113","39137","Putnam County, Ohio",13158,192,12146,245,10221,309,656,135,11490,236,1925,232,1012,172
"2114","39139","Richland County, Ohio",49505,550,43996,797,35210,841,2803,434,41193,814,8786,708,5509,524
"2115","39141","Ross County, Ohio",29455,412,26428,569,21178,631,1498,253,24930,595,5250,516,3027,435
"2116","39143","Sandusky County, Ohio",23797,380,21458,481,17621,584,1226,177,20232,471,3837,416,2339,333
"2117","39145","Scioto County, Ohio",28152,589,24159,700,18267,686,1348,260,22811,705,5892,544,3993,484
"2118","39147","Seneca County, Ohio",21862,378,19749,453,15786,432,1087,161,18662,471,3963,439,2113,274
"2119","39149","Shelby County, Ohio",18429,333,16898,356,14184,398,1211,228,15687,407,2714,304,1531,217
"2120","39151","Stark County, Ohio",154426,903,141552,982,114615,1228,6843,501,134709,1062,26937,1121,12874,739
"2121","39153","Summit County, Ohio",228283,1175,211090,1298,177119,1844,10663,664,200427,1435,33971,1504,17193,967
"2122","39155","Trumbull County, Ohio",84989,753,74089,940,58642,1140,4432,432,69657,1048,15447,978,10900,789
"2123","39157","Tuscarawas County, Ohio",37661,465,33366,593,25703,685,1607,223,31759,623,7663,631,4295,384
"2124","39159","Union County, Ohio",21654,355,20730,364,18510,444,734,162,19996,416,2220,341,924,196
"2125","39161","Van Wert County, Ohio",11553,186,10492,262,8435,340,636,130,9856,242,2057,270,1061,170
"2126","39163","Vinton County, Ohio",5052,216,3981,288,3147,298,160,68,3821,266,834,160,1071,217
"2127","39165","Warren County, Ohio",86981,813,84115,878,76676,985,2136,345,81979,930,7439,713,2866,419
"2128","39167","Washington County, Ohio",24435,427,21433,500,17624,549,1507,261,19926,528,3809,366,3002,321
"2129","39169","Wayne County, Ohio",43964,831,38152,917,32231,937,2461,246,35691,919,5921,481,5812,426
"2130","39171","Williams County, Ohio",15261,243,13604,308,11221,411,996,194,12608,380,2383,341,1657,235
"2131","39173","Wood County, Ohio",53010,613,50470,689,44333,905,2137,314,48333,718,6137,625,2540,355
"2132","39175","Wyandot County, Ohio",9036,214,8281,239,6689,264,580,130,7701,258,1592,220,755,138
"2133","40001","Adair County, Oklahoma",6770,126,5106,174,3313,168,366,70,4740,182,1793,159,1664,153
"2134","40003","Alfalfa County, Oklahoma",1812,102,1661,110,1317,100,107,35,1554,113,344,62,151,40
"2135","40005","Atoka County, Oklahoma",4886,144,4178,150,2684,149,128,57,4050,159,1494,163,708,86
"2136","40007","Beaver County, Oklahoma",1781,89,1641,87,1222,90,116,39,1525,81,419,73,140,42
"2137","40009","Beckham County, Oklahoma",7907,381,7348,387,5080,446,293,150,7055,381,2268,389,559,187
"2138","40011","Blaine County, Oklahoma",3542,200,3187,210,2142,200,126,57,3061,208,1045,169,355,104
"2139","40013","Bryan County, Oklahoma",17731,223,15929,265,11786,386,537,111,15392,280,4143,358,1802,190
"2140","40015","Caddo County, Oklahoma",9094,199,7927,233,5179,252,308,75,7619,248,2748,178,1167,151
"2141","40017","Canadian County, Oklahoma",54871,537,52620,640,45737,806,1655,324,50965,626,6883,763,2251,366
"2142","40019","Carter County, Oklahoma",18441,239,16710,308,11332,410,753,150,15957,339,5378,360,1731,220
"2143","40021","Cherokee County, Oklahoma",17486,286,15383,379,11373,450,738,154,14645,376,4010,372,2103,290
"2144","40023","Choctaw County, Oklahoma",5756,132,4862,163,3030,191,261,73,4601,164,1832,202,894,125
"2145","40025","Cimarron County, Oklahoma",829,70,704,77,399,72,14,9,690,77,305,63,125,38
"2146","40027","Cleveland County, Oklahoma",112437,855,107599,1035,93439,1296,3028,358,104571,1074,14160,981,4838,630
"2147","40029","Coal County, Oklahoma",2092,83,1745,80,1094,85,71,28,1674,84,651,87,347,62
"2148","40031","Comanche County, Oklahoma",44138,822,41309,898,32427,865,1552,324,39757,927,8882,714,2829,432
"2149","40033","Cotton County, Oklahoma",2001,117,1767,116,1224,120,117,49,1650,119,543,92,234,71
"2150","40035","Craig County, Oklahoma",5197,162,4562,166,3110,177,255,82,4307,166,1452,161,635,100
"2151","40037","Creek County, Oklahoma",27031,283,24748,340,18861,445,987,178,23761,378,5887,367,2283,254
"2152","40039","Custer County, Oklahoma",10882,384,10341,396,8023,474,132,66,10209,398,2318,334,541,163
"2153","40041","Delaware County, Oklahoma",16342,313,14534,345,11078,399,926,141,13608,351,3456,277,1808,231
"2154","40043","Dewey County, Oklahoma",1503,76,1362,86,937,77,62,27,1300,89,425,69,141,41
"2155","40045","Ellis County, Oklahoma",1468,96,1295,103,1016,105,85,44,1210,100,279,61,173,39
"2156","40047","Garfield County, Oklahoma",23875,461,21730,537,16796,605,1049,223,20681,537,4934,570,2145,357
"2157","40049","Garvin County, Oklahoma",9888,151,8997,199,6269,243,198,45,8799,202,2728,207,891,126
"2158","40051","Grady County, Oklahoma",20119,234,18119,301,14489,408,700,141,17419,336,3630,340,2000,227
"2159","40053","Grant County, Oklahoma",1508,90,1358,89,1004,87,73,26,1285,92,354,71,150,51
"2160","40055","Greer County, Oklahoma",2079,133,1840,160,1198,144,79,46,1761,175,642,158,239,85
"2161","40057","Harmon County, Oklahoma",956,79,822,95,513,77,20,19,802,97,309,76,134,77
"2162","40059","Harper County, Oklahoma",1196,82,1050,90,849,89,43,25,1007,95,201,70,146,59
"2163","40061","Haskell County, Oklahoma",4576,114,3893,116,2732,116,174,61,3719,122,1161,120,683,76
"2164","40063","Hughes County, Oklahoma",3897,150,2994,157,2238,140,371,74,2623,153,756,133,903,109
"2165","40065","Jackson County, Oklahoma",9671,337,8885,380,6777,389,486,140,8399,378,2108,355,786,152
"2166","40067","Jefferson County, Oklahoma",2057,81,1787,84,1131,82,95,30,1692,82,656,71,270,59
"2167","40069","Johnston County, Oklahoma",3907,123,3204,147,2140,150,183,83,3021,162,1064,123,703,116
"2168","40071","Kay County, Oklahoma",16916,328,15029,349,11529,325,925,159,14104,372,3500,286,1887,226
"2169","40073","Kingfisher County, Oklahoma",5528,181,5144,203,3720,270,176,85,4968,215,1424,243,384,139
"2170","40075","Kiowa County, Oklahoma",3272,143,2760,167,2033,178,214,86,2546,159,727,129,512,106
"2171","40077","Latimer County, Oklahoma",3852,90,3299,127,2178,146,98,38,3201,132,1121,98,553,101
"2172","40079","Le Flore County, Oklahoma",17623,249,15092,310,10412,373,983,146,14109,306,4680,305,2531,214
"2173","40081","Lincoln County, Oklahoma",12550,184,11168,220,8025,334,460,108,10708,231,3143,300,1382,160
"2174","40083","Logan County, Oklahoma",17130,412,15959,504,12997,516,719,191,15240,501,2962,396,1171,274
"2175","40085","Love County, Oklahoma",3552,110,3187,131,2195,143,113,41,3074,139,992,127,365,67
"2176","40087","McClain County, Oklahoma",14836,190,13929,264,11397,356,469,141,13460,315,2532,294,907,192
"2177","40089","McCurtain County, Oklahoma",11235,191,9029,240,6529,277,591,116,8438,235,2500,231,2206,204
"2178","40091","McIntosh County, Oklahoma",7233,231,6182,272,4158,282,393,128,5789,282,2024,214,1051,150
"2179","40093","Major County, Oklahoma",3171,117,2969,116,2212,116,185,65,2784,121,757,101,202,53
"2180","40095","Marshall County, Oklahoma",5613,167,4806,187,3446,223,210,60,4596,187,1360,156,807,147
"2181","40097","Mayes County, Oklahoma",15070,220,13449,275,9870,291,507,92,12942,288,3579,283,1621,209
"2182","40099","Murray County, Oklahoma",4929,203,4392,227,3049,245,214,79,4178,226,1343,174,537,142
"2183","40101","Muskogee County, Oklahoma",25455,355,22410,433,16124,575,755,158,21655,465,6286,453,3045,293
"2184","40103","Noble County, Oklahoma",4202,159,3628,213,2929,202,173,92,3455,225,699,122,574,135
"2185","40105","Nowata County, Oklahoma",3742,104,3220,119,2327,114,178,55,3042,129,893,101,522,93
"2186","40107","Okfuskee County, Oklahoma",3780,178,3260,175,2226,175,144,45,3116,175,1034,101,520,73
"2187","40109","Oklahoma County, Oklahoma",313822,1611,292826,1855,233792,2545,9775,699,283051,1850,59034,1950,20996,1121
"2188","40111","Okmulgee County, Oklahoma",13959,192,12320,264,8440,333,575,124,11745,293,3880,299,1639,202
"2189","40113","Osage County, Oklahoma",16824,264,15114,344,11517,346,592,127,14522,351,3597,254,1710,247
"2190","40115","Ottawa County, Oklahoma",11728,115,10294,133,7127,200,490,56,9804,129,3167,164,1434,93
"2191","40117","Pawnee County, Oklahoma",5900,121,5299,131,3759,138,218,77,5081,150,1540,118,601,75
"2192","40119","Payne County, Oklahoma",31197,687,29402,712,24694,910,868,168,28534,704,4708,551,1795,312
"2193","40121","Pittsburg County, Oklahoma",17112,280,15081,320,10823,363,480,93,14601,325,4258,321,2031,230
"2194","40123","Pontotoc County, Oklahoma",14604,250,13375,288,9696,340,328,94,13047,297,3679,267,1229,159
"2195","40125","Pottawatomie County, Oklahoma",26237,278,23961,348,17922,409,974,150,22987,365,6039,370,2276,218
"2196","40127","Pushmataha County, Oklahoma",4189,132,3407,159,2269,160,196,53,3211,160,1138,129,782,102
"2197","40129","Roger Mills County, Oklahoma",1403,78,1276,89,878,83,38,25,1238,91,398,71,127,34
"2198","40131","Rogers County, Oklahoma",34465,297,32730,353,26934,443,1514,222,31216,415,5796,402,1735,206
"2199","40133","Seminole County, Oklahoma",8581,155,7054,183,4726,168,379,72,6675,184,2328,141,1527,130
"2200","40135","Sequoyah County, Oklahoma",14623,198,12874,247,8529,349,515,93,12359,253,4345,328,1749,196
"2201","40137","Stephens County, Oklahoma",16633,278,15107,319,11026,321,602,116,14505,350,4081,339,1526,206
"2202","40139","Texas County, Oklahoma",6890,267,6410,309,4351,336,210,112,6200,302,2059,276,480,139
"2203","40141","Tillman County, Oklahoma",2625,163,2225,169,1508,151,218,61,2007,165,717,145,400,92
"2204","40143","Tulsa County, Oklahoma",260639,777,244862,1131,198994,1384,8146,508,236716,1258,45868,1024,15777,755
"2205","40145","Wagoner County, Oklahoma",29280,231,27695,320,22779,450,1061,171,26634,336,4916,339,1585,243
"2206","40147","Washington County, Oklahoma",20382,228,18550,303,15012,433,827,178,17723,366,3538,357,1832,266
"2207","40149","Washita County, Oklahoma",4076,162,3688,189,2821,183,115,43,3573,188,867,138,388,109
"2208","40151","Woods County, Oklahoma",3332,228,3006,235,2319,211,130,57,2876,236,687,158,326,103
"2209","40153","Woodward County, Oklahoma",7952,229,7291,291,5003,378,356,135,6935,317,2288,339,661,189
"2210","41001","Baker County, Oregon",6976,187,6283,204,5433,244,793,158,5490,220,850,172,693,136
"2211","41003","Benton County, Oregon",37370,455,36191,553,33802,610,1500,313,34691,644,2389,318,1179,262
"2212","41005","Clackamas County, Oregon",159553,832,153013,1051,139059,1415,6157,563,146856,1044,13954,1046,6540,726
"2213","41007","Clatsop County, Oregon",16649,497,15592,539,13465,574,861,206,14731,557,2127,320,1057,190
"2214","41009","Columbia County, Oregon",19933,334,18708,368,16088,560,898,169,17810,347,2620,403,1225,220
"2215","41011","Coos County, Oregon",27627,528,25054,575,20293,593,2236,359,22818,640,4761,463,2573,354
"2216","41013","Crook County, Oregon",9951,263,9169,322,8058,397,468,142,8701,343,1111,283,782,198
"2217","41015","Curry County, Oregon",10788,295,9783,333,8479,384,1161,293,8622,361,1304,299,1005,250
"2218","41017","Deschutes County, Oregon",79329,923,76796,994,69959,1139,3008,446,73788,1070,6837,790,2533,514
"2219","41019","Douglas County, Oregon",45663,546,41108,793,33960,953,3329,415,37779,824,7148,686,4555,507
"2220","41021","Gilliam County, Oregon",902,59,805,71,706,81,130,65,675,64,99,34,97,48
"2221","41023","Grant County, Oregon",3274,126,2926,147,2405,160,369,98,2557,161,521,113,348,92
"2222","41025","Harney County, Oregon",3076,156,2733,182,2257,214,271,90,2462,188,476,159,343,124
"2223","41027","Hood River County, Oregon",8949,281,8412,302,7121,315,328,114,8084,291,1291,276,537,172
"2224","41029","Jackson County, Oregon",89467,692,84374,838,72661,1119,4140,478,80234,889,11713,869,5093,580
"2225","41031","Jefferson County, Oregon",8244,212,7718,255,6433,292,332,99,7386,262,1285,205,526,127
"2226","41033","Josephine County, Oregon",36148,445,33673,561,28216,674,2731,348,30942,655,5457,614,2475,391
"2227","41035","Klamath County, Oregon",28027,398,26218,419,20783,615,1418,219,24800,494,5435,522,1809,212
"2228","41037","Lake County, Oregon",3427,177,2974,218,2187,203,197,89,2777,222,787,170,453,135
"2229","41039","Lane County, Oregon",157183,721,150102,992,131939,1363,8149,668,141953,990,18163,1030,7081,602
"2230","41041","Lincoln County, Oregon",22093,510,20705,552,17760,547,1540,217,19165,542,2945,367,1388,232
"2231","41043","Linn County, Oregon",49113,440,46342,499,38713,797,2423,394,43919,617,7629,699,2771,331
"2232","41045","Malheur County, Oregon",9783,236,8610,319,6574,393,644,139,7966,313,2036,270,1173,197
"2233","41047","Marion County, Oregon",121132,744,115191,855,98064,1221,5682,491,109509,968,17127,1082,5941,561
"2234","41049","Morrow County, Oregon",4085,134,3867,143,2916,188,201,72,3666,137,951,150,218,80
"2235","41051","Multnomah County, Oregon",339228,1340,324841,1658,291263,2028,9431,662,315410,1755,33578,1447,14387,988
"2236","41053","Polk County, Oregon",31742,386,30178,474,26375,615,1522,320,28656,560,3803,465,1564,309
"2237","41055","Sherman County, Oregon",711,62,660,61,542,53,75,26,585,60,118,41,51,21
"2238","41057","Tillamook County, Oregon",11381,410,10417,431,8751,474,809,174,9608,471,1666,353,964,239
"2239","41059","Umatilla County, Oregon",27012,503,24595,608,20075,642,1060,258,23535,646,4520,501,2417,349
"2240","41061","Union County, Oregon",10536,231,9604,266,7986,339,655,126,8949,291,1618,222,932,178
"2241","41063","Wallowa County, Oregon",3269,128,2936,148,2575,156,267,102,2669,148,361,97,333,89
"2242","41065","Wasco County, Oregon",10345,274,9424,309,7737,323,597,132,8827,297,1687,271,921,176
"2243","41067","Washington County, Oregon",226412,789,220035,1064,203870,1508,6797,555,213238,1075,16165,962,6377,666
"2244","41069","Wheeler County, Oregon",630,62,556,59,475,60,65,32,491,58,81,30,74,28
"2245","41071","Yamhill County, Oregon",38083,345,35979,540,31749,763,1902,261,34077,615,4230,597,2104,397
"2246","42001","Adams County, Pennsylvania",39908,443,36110,535,31048,597,2512,295,33598,604,5062,447,3798,329
"2247","42003","Allegheny County, Pennsylvania",545763,2113,499777,2472,430274,2806,25793,1060,473984,2565,69503,1845,45986,1404
"2248","42005","Armstrong County, Pennsylvania",27704,337,24052,386,20098,372,1714,209,22338,391,3954,283,3652,308
"2249","42007","Beaver County, Pennsylvania",71717,591,64245,733,52772,959,3730,341,60515,816,11473,854,7472,586
"2250","42009","Bedford County, Pennsylvania",19334,331,16109,388,13046,415,1701,195,14408,415,3063,300,3225,263
"2251","42011","Berks County, Pennsylvania",160065,886,144499,1302,119656,1583,8587,788,135912,1348,24843,1307,15566,990
"2252","42013","Blair County, Pennsylvania",50264,540,43584,680,35898,822,3138,350,40446,744,7686,554,6680,530
"2253","42015","Bradford County, Pennsylvania",24287,328,21559,334,17586,458,2107,155,19452,339,3973,354,2728,199
"2254","42017","Bucks County, Pennsylvania",245200,861,233188,1170,212224,1444,9846,802,223342,1289,20964,1002,12012,807
"2255","42019","Butler County, Pennsylvania",78365,613,71832,731,62498,922,4372,502,67460,853,9334,719,6533,479
"2256","42021","Cambria County, Pennsylvania",55519,614,47425,732,38297,776,3541,311,43884,760,9128,580,8094,616
"2257","42023","Cameron County, Pennsylvania",2131,97,1872,112,1461,113,258,55,1614,107,411,77,259,60
"2258","42025","Carbon County, Pennsylvania",26312,531,23578,607,19127,610,1793,338,21785,683,4451,497,2734,423
"2259","42027","Centre County, Pennsylvania",57834,789,53428,820,48536,952,3106,425,50322,849,4892,557,4406,474
"2260","42029","Chester County, Pennsylvania",198159,968,188790,1060,173876,1362,9393,673,179397,1140,14914,1073,9369,696
"2261","42031","Clarion County, Pennsylvania",14632,321,12548,369,10676,372,979,122,11569,380,1872,182,2084,163
"2262","42033","Clearfield County, Pennsylvania",31195,491,26661,527,22082,590,2348,324,24313,524,4579,377,4534,345
"2263","42035","Clinton County, Pennsylvania",14620,262,12554,324,10580,317,897,146,11657,304,1974,242,2066,207
"2264","42037","Columbia County, Pennsylvania",25717,462,22974,523,18822,516,1614,223,21360,508,4152,402,2743,291
"2265","42039","Crawford County, Pennsylvania",33225,474,28959,531,23467,601,2520,246,26439,525,5492,388,4266,311
"2266","42041","Cumberland County, Pennsylvania",102532,725,94454,1001,85036,1112,4967,516,89487,1108,9418,795,8078,706
"2267","42043","Dauphin County, Pennsylvania",115703,1728,104652,1896,88124,1865,6070,597,98582,1936,16528,961,11051,796
"2268","42045","Delaware County, Pennsylvania",214252,919,201312,1136,175283,1615,9152,825,192160,1389,26029,1278,12940,807
"2269","42047","Elk County, Pennsylvania",13499,218,11717,357,9931,346,1132,184,10585,373,1786,264,1782,309
"2270","42049","Erie County, Pennsylvania",108861,839,98901,922,80177,1338,5499,496,93402,1027,18724,1143,9960,618
"2271","42051","Fayette County, Pennsylvania",54097,723,45944,837,36387,848,3315,446,42629,777,9557,623,8153,669
"2272","42053","Forest County, Pennsylvania",1786,155,1463,142,1143,123,125,32,1338,135,320,57,323,59
"2273","42055","Franklin County, Pennsylvania",61854,500,55734,798,47710,897,3819,459,51915,880,8024,719,6120,623
"2274","42057","Fulton County, Pennsylvania",5990,127,5034,165,4171,157,463,68,4571,160,863,109,956,97
"2275","42059","Greene County, Pennsylvania",13957,325,12371,340,9984,411,866,126,11505,370,2387,344,1586,184
"2276","42061","Huntingdon County, Pennsylvania",15588,351,13665,329,11171,317,1375,145,12290,325,2494,236,1923,158
"2277","42063","Indiana County, Pennsylvania",32425,621,27850,706,22683,756,2328,339,25522,693,5167,405,4575,356
"2278","42065","Jefferson County, Pennsylvania",17745,295,15130,293,12180,285,1197,121,13933,297,2950,227,2615,214
"2279","42067","Juniata County, Pennsylvania",8756,168,7169,252,5685,256,639,102,6530,260,1484,204,1587,195
"2280","42069","Lackawanna County, Pennsylvania",87217,783,78264,886,65094,1083,4425,402,73839,881,13170,784,8953,522
"2281","42071","Lancaster County, Pennsylvania",207291,861,185565,1288,161781,1590,9940,830,175625,1393,23784,1299,21726,907
"2282","42073","Lawrence County, Pennsylvania",36111,422,31935,447,25776,623,2044,311,29891,463,6159,516,4176,382
"2283","42075","Lebanon County, Pennsylvania",54758,519,49103,708,40095,858,3101,308,46002,744,9008,794,5655,501
"2284","42077","Lehigh County, Pennsylvania",141775,795,130260,1130,110045,1654,5916,458,124344,1049,20215,1134,11515,827
"2285","42079","Luzerne County, Pennsylvania",131556,949,116331,1110,93537,1477,7182,466,109149,1136,22794,870,15225,751
"2286","42081","Lycoming County, Pennsylvania",45504,638,40931,786,33437,826,3095,339,37836,785,7494,588,4573,483
"2287","42083","McKean County, Pennsylvania",15776,296,13946,296,11261,360,1162,139,12784,305,2685,286,1830,178
"2288","42085","Mercer County, Pennsylvania",45798,493,39701,572,31225,726,2588,246,37113,625,8476,595,6097,473
"2289","42087","Mifflin County, Pennsylvania",18641,329,15736,425,12385,512,1199,192,14537,416,3351,346,2905,350
"2290","42089","Monroe County, Pennsylvania",59208,1153,55754,1205,48993,1146,2506,343,53248,1202,6761,672,3454,436
"2291","42091","Montgomery County, Pennsylvania",327065,1082,311661,1314,286333,1612,11935,758,299726,1521,25328,1083,15404,868
"2292","42093","Montour County, Pennsylvania",7476,201,6455,239,5471,230,403,101,6052,268,984,173,1021,155
"2293","42095","Northampton County, Pennsylvania",119208,750,108921,951,94854,1081,5410,496,103511,1087,14067,958,10287,581
"2294","42097","Northumberland County, Pennsylvania",37369,549,31778,614,25420,697,2461,247,29317,673,6358,451,5591,418
"2295","42099","Perry County, Pennsylvania",17823,201,15677,269,13336,336,1245,143,14432,277,2341,233,2146,192
"2296","42101","Philadelphia County, Pennsylvania",646608,2427,585244,3005,468387,4079,22824,1503,562420,3186,116857,3016,61364,1979
"2297","42103","Pike County, Pennsylvania",23351,495,21853,546,19393,576,1746,360,20107,549,2460,406,1498,293
"2298","42105","Potter County, Pennsylvania",6385,190,5679,195,4656,174,593,80,5086,217,1023,109,706,89
"2299","42107","Schuylkill County, Pennsylvania",56763,673,49890,748,41044,892,3632,354,46258,744,8846,733,6873,483
"2300","42109","Snyder County, Pennsylvania",14373,295,12288,352,10580,371,803,119,11485,347,1708,190,2085,210
"2301","42111","Somerset County, Pennsylvania",28857,436,24257,490,19622,508,2165,261,22092,506,4635,393,4600,341
"2302","42113","Sullivan County, Pennsylvania",2398,128,2112,123,1822,110,331,57,1781,120,290,46,286,51
"2303","42115","Susquehanna County, Pennsylvania",15430,233,13834,257,11721,288,1316,133,12518,268,2113,196,1596,144
"2304","42117","Tioga County, Pennsylvania",16340,282,14373,315,11975,321,1559,164,12814,330,2398,221,1967,167
"2305","42119","Union County, Pennsylvania",13880,400,11751,490,10113,516,1413,317,10338,420,1638,262,2129,326
"2306","42121","Venango County, Pennsylvania",21033,335,18729,392,15166,484,1425,187,17304,418,3563,362,2304,239
"2307","42123","Warren County, Pennsylvania",16070,239,14121,283,11812,283,1460,184,12661,319,2309,207,1949,208
"2308","42125","Washington County, Pennsylvania",86028,699,77967,815,64985,1019,4321,438,73646,856,12982,750,8061,557
"2309","42127","Wayne County, Pennsylvania",19379,454,17222,543,14445,498,1632,193,15590,599,2777,371,2157,292
"2310","42129","Westmoreland County, Pennsylvania",152288,816,136195,1116,115900,1457,9057,641,127138,1149,20295,940,16093,812
"2311","42131","Wyoming County, Pennsylvania",10600,209,9682,220,8077,223,720,100,8962,223,1605,177,918,107
"2312","42133","York County, Pennsylvania",176428,880,161964,1207,136863,1670,8127,555,153837,1298,25101,1329,14464,876
"2313","44001","Bristol County, Rhode Island",19273,514,17553,558,15950,643,978,193,16575,593,1603,294,1720,270
"2314","44003","Kent County, Rhode Island",71737,563,66351,870,58215,942,3711,442,62640,922,8136,856,5386,691
"2315","44005","Newport County, Rhode Island",35329,725,33309,788,29959,840,1914,350,31395,871,3350,370,2020,298
"2316","44007","Providence County, Rhode Island",249592,1353,227307,1629,185683,2084,10781,760,216526,1858,41624,1554,22285,1254
"2317","44009","Washington County, Rhode Island",50838,758,48442,776,43951,818,2337,398,46105,856,4491,482,2396,339
"2318","45001","Abbeville County, South Carolina",9423,358,8087,461,6030,440,661,204,7426,470,2057,302,1336,268
"2319","45003","Aiken County, South Carolina",66980,796,61549,933,49848,1147,2752,377,58797,959,11701,957,5431,570
"2320","45005","Allendale County, South Carolina",3072,219,2185,256,1223,188,91,48,2094,258,962,215,887,150
"2321","45007","Anderson County, South Carolina",78836,793,72014,1036,57074,1209,3344,571,68670,1134,14940,1063,6822,682
"2322","45009","Bamberg County, South Carolina",4562,266,3956,298,2699,312,274,167,3682,314,1257,290,606,192
"2323","45011","Barnwell County, South Carolina",8253,283,6799,306,4482,320,329,120,6470,311,2317,326,1454,259
"2324","45013","Beaufort County, South Carolina",73337,960,70515,1028,60961,1150,1892,343,68623,1027,9554,794,2822,431
"2325","45015","Berkeley County, South Carolina",84085,710,78942,855,66526,1196,2764,401,76178,867,12416,991,5143,562
"2326","45017","Calhoun County, South Carolina",5789,247,5063,254,3738,306,308,144,4755,260,1325,269,726,198
"2327","45019","Charleston County, South Carolina",167853,1434,158414,1435,133250,1736,5428,668,152986,1479,25164,1255,9439,764
"2328","45021","Cherokee County, South Carolina",21081,457,18196,499,13069,567,719,160,17477,535,5127,549,2885,477
"2329","45023","Chester County, South Carolina",12672,292,10897,351,8197,377,836,183,10061,362,2700,360,1775,241
"2330","45025","Chesterfield County, South Carolina",17186,458,14466,506,10595,548,799,248,13667,538,3871,390,2720,401
"2331","45027","Clarendon County, South Carolina",11585,350,9861,370,7420,338,494,125,9367,387,2441,280,1724,212
"2332","45029","Colleton County, South Carolina",15059,389,13590,502,9292,603,717,215,12873,535,4298,551,1469,328
"2333","45031","Darlington County, South Carolina",25239,569,21397,575,15998,761,1553,389,19844,630,5399,601,3842,408
"2334","45033","Dillon County, South Carolina",10313,373,7769,504,4772,411,322,118,7447,472,2997,397,2544,362
"2335","45035","Dorchester County, South Carolina",58282,799,55181,897,47934,1040,1778,354,53403,950,7247,759,3101,540
"2336","45037","Edgefield County, South Carolina",9102,278,7896,330,5855,298,459,159,7437,372,2041,284,1206,225
"2337","45039","Fairfield County, South Carolina",8758,962,7572,990,6046,1019,358,144,7214,951,1526,326,1186,242
"2338","45041","Florence County, South Carolina",51791,721,46010,806,34762,1089,1592,292,44418,785,11248,863,5781,491
"2339","45043","Georgetown County, South Carolina",25690,695,23281,781,19296,769,1553,336,21728,826,3985,563,2409,362
"2340","45045","Greenville County, South Carolina",205490,1106,191839,1332,161648,1751,7115,654,184724,1451,30191,1590,13651,941
"2341","45047","Greenwood County, South Carolina",27403,494,23812,577,18110,657,1165,272,22647,629,5702,527,3591,386
"2342","45049","Hampton County, South Carolina",6793,277,5891,351,4124,327,366,122,5525,354,1767,297,902,192
"2343","45051","Horry County, South Carolina",134609,1526,126668,1658,102257,1604,5742,585,120926,1653,24411,1222,7941,761
"2344","45053","Jasper County, South Carolina",11084,342,9580,435,7196,506,136,76,9444,446,2384,398,1504,339
"2345","45055","Kershaw County, South Carolina",24901,444,22818,529,19484,546,1032,222,21786,550,3334,419,2083,363
"2346","45057","Lancaster County, South Carolina",36597,661,33506,769,27497,850,1301,348,32205,769,6009,736,3091,459
"2347","45059","Laurens County, South Carolina",25282,468,21950,615,16355,708,1101,218,20849,638,5595,548,3332,381
"2348","45061","Lee County, South Carolina",6322,292,5047,324,3592,355,259,124,4788,310,1455,226,1275,213
"2349","45063","Lexington County, South Carolina",115880,791,108561,1000,90676,1378,3700,445,104861,1114,17885,1112,7319,653
"2350","45065","McCormick County, South Carolina",3768,202,3153,223,2480,211,319,123,2834,226,673,161,615,146
"2351","45067","Marion County, South Carolina",10844,405,8467,432,5282,447,459,147,8008,429,3185,352,2377,321
"2352","45069","Marlboro County, South Carolina",9331,322,7010,366,4335,374,234,77,6776,370,2675,346,2321,306
"2353","45071","Newberry County, South Carolina",15137,387,12983,540,9963,572,580,153,12403,544,3020,428,2154,409
"2354","45073","Oconee County, South Carolina",32413,733,29045,753,22524,816,1777,348,27268,734,6521,678,3368,451
"2355","45075","Orangeburg County, South Carolina",32164,787,27058,850,19979,718,858,166,26200,849,7079,668,5106,521
"2356","45077","Pickens County, South Carolina",49438,735,44312,847,36003,953,1792,281,42520,927,8309,733,5126,577
"2357","45079","Richland County, South Carolina",160231,1262,152685,1342,125954,1874,3857,474,148828,1547,26731,1571,7546,637
"2358","45081","Saluda County, South Carolina",7227,271,6278,363,4422,337,322,117,5956,369,1856,301,949,217
"2359","45083","Spartanburg County, South Carolina",122044,913,111172,1225,89058,1459,5368,634,105804,1296,22114,1148,10872,812
"2360","45085","Sumter County, South Carolina",40789,696,35788,740,28070,883,1478,299,34310,721,7718,667,5001,525
"2361","45087","Union County, South Carolina",11150,314,9472,340,5925,415,591,150,8881,367,3547,403,1678,226
"2362","45089","Williamsburg County, South Carolina",12032,335,9460,375,6533,398,492,132,8968,394,2927,423,2572,328
"2363","45091","York County, South Carolina",106570,705,101311,878,85678,1116,3125,521,98186,965,15633,984,5259,606
"2364","46003","Aurora County, South Dakota",1047,67,916,65,697,63,79,27,837,63,219,60,131,36
"2365","46005","Beadle County, South Dakota",7617,230,6699,281,5230,281,482,158,6217,292,1469,228,918,190
"2366","46007","Bennett County, South Dakota",991,96,790,100,668,95,105,48,685,89,122,48,201,47
"2367","46009","Bon Homme County, South Dakota",2445,143,2091,160,1742,157,197,49,1894,154,349,74,354,68
"2368","46011","Brookings County, South Dakota",13233,373,12505,422,10759,404,372,100,12133,427,1746,268,728,156
"2369","46013","Brown County, South Dakota",16200,332,14689,380,12118,439,781,194,13908,382,2571,370,1511,250
"2370","46015","Brule County, South Dakota",1990,121,1728,108,1437,121,143,50,1585,121,291,84,262,69
"2371","46017","Buffalo County, South Dakota",517,59,382,56,202,43,19,20,363,55,180,50,135,39
"2372","46019","Butte County, South Dakota",3993,221,3654,240,3034,270,406,130,3248,222,620,168,339,103
"2373","46021","Campbell County, South Dakota",654,62,536,62,448,57,32,18,504,61,88,36,118,38
"2374","46023","Charles Mix County, South Dakota",2959,88,2522,115,2005,117,212,46,2310,108,517,88,437,68
"2375","46025","Clark County, South Dakota",1383,67,1250,69,1078,82,100,35,1150,73,172,45,133,43
"2376","46027","Clay County, South Dakota",5322,226,5022,244,4473,260,149,58,4873,255,549,151,300,107
"2377","46029","Codington County, South Dakota",11963,290,10830,373,8733,403,570,161,10260,404,2097,340,1133,218
"2378","46031","Corson County, South Dakota",1070,35,777,48,698,47,127,30,650,50,79,22,293,38
"2379","46033","Custer County, South Dakota",3626,234,3289,257,2790,285,229,85,3060,268,499,153,337,112
"2380","46035","Davison County, South Dakota",8485,317,7527,407,5839,391,399,144,7128,417,1688,311,958,250
"2381","46037","Day County, South Dakota",2303,101,2043,114,1632,114,168,51,1875,129,411,78,260,58
"2382","46039","Deuel County, South Dakota",1794,99,1570,87,1229,92,75,28,1495,84,341,73,224,53
"2383","46041","Dewey County, South Dakota",1650,53,1218,63,956,70,179,36,1039,61,262,55,432,59
"2384","46043","Douglas County, South Dakota",1089,59,949,72,794,57,32,21,917,69,155,48,140,37
"2385","46045","Edmunds County, South Dakota",1489,96,1372,94,1176,98,103,38,1269,98,196,69,117,35
"2386","46047","Fall River County, South Dakota",3149,181,2748,192,2244,190,266,126,2482,216,504,165,401,118
"2387","46049","Faulk County, South Dakota",764,90,684,79,555,74,35,21,649,75,129,34,80,31
"2388","46051","Grant County, South Dakota",3039,162,2692,180,2204,204,189,75,2503,168,488,146,347,99
"2389","46053","Gregory County, South Dakota",1567,84,1328,79,1065,82,131,37,1197,82,263,60,239,51
"2390","46055","Haakon County, South Dakota",712,66,637,78,482,66,60,26,577,82,155,78,75,37
"2391","46057","Hamlin County, South Dakota",2080,94,1904,96,1539,92,88,26,1816,94,365,67,176,44
"2392","46059","Hand County, South Dakota",1358,88,1203,84,1013,76,67,20,1136,87,190,48,155,47
"2393","46061","Hanson County, South Dakota",1096,53,1013,62,897,72,33,14,980,64,116,35,83,29
"2394","46063","Harding County, South Dakota",511,67,473,60,437,55,31,14,442,62,36,22,38,20
"2395","46065","Hughes County, South Dakota",7490,217,7000,277,6090,316,567,160,6433,296,910,199,490,197
"2396","46067","Hutchinson County, South Dakota",2912,90,2449,96,2055,107,212,51,2237,100,394,69,463,101
"2397","46069","Hyde County, South Dakota",548,64,484,61,440,62,39,17,445,59,44,26,64,34
"2398","46071","Jackson County, South Dakota",722,83,556,80,420,87,31,26,525,75,136,45,166,55
"2399","46073","Jerauld County, South Dakota",847,74,769,75,603,74,67,30,702,75,166,45,78,36
"2400","46075","Jones County, South Dakota",381,55,338,54,295,53,21,13,317,56,43,22,43,33
"2401","46077","Kingsbury County, South Dakota",1991,94,1795,91,1548,94,129,32,1666,94,247,51,196,52
"2402","46079","Lake County, South Dakota",4619,241,4390,248,3802,237,238,103,4152,249,588,170,229,77
"2403","46081","Lawrence County, South Dakota",11109,465,10051,497,8835,480,562,129,9489,501,1216,228,1058,275
"2404","46083","Lincoln County, South Dakota",24719,252,24110,322,22098,454,971,239,23139,413,2012,325,609,185
"2405","46085","Lyman County, South Dakota",1215,73,1071,75,770,66,47,20,1024,79,301,56,144,42
"2406","46087","McCook County, South Dakota",2176,86,2025,88,1678,88,89,34,1936,91,347,74,151,56
"2407","46089","McPherson County, South Dakota",872,66,676,61,577,61,40,25,636,62,99,42,196,52
"2408","46091","Marshall County, South Dakota",1708,97,1543,83,1306,89,128,46,1415,97,237,63,165,54
"2409","46093","Meade County, South Dakota",11157,297,10052,341,8869,419,517,147,9535,325,1183,281,1105,222
"2410","46095","Mellette County, South Dakota",586,52,387,51,322,48,31,19,356,49,65,25,199,50
"2411","46097","Miner County, South Dakota",910,63,837,64,629,66,63,33,774,62,208,50,73,27
"2412","46099","Minnehaha County, South Dakota",77998,644,74139,660,62609,1040,2713,350,71426,784,11530,894,3859,376
"2413","46101","Moody County, South Dakota",2474,128,2304,126,1877,116,148,52,2156,118,427,87,170,44
"2414","46102","Oglala Lakota County, South Dakota",2595,141,1729,165,1277,166,189,84,1540,158,452,119,866,167
"2415","46103","Pennington County, South Dakota",44003,496,40890,599,34816,742,2607,350,38283,697,6074,550,3113,383
"2416","46105","Perkins County, South Dakota",1280,80,1147,84,1032,83,200,62,947,90,115,35,133,34
"2417","46107","Potter County, South Dakota",1067,86,964,89,790,83,67,25,897,95,174,45,103,33
"2418","46109","Roberts County, South Dakota",3648,111,3111,104,2399,120,229,55,2882,114,712,84,537,74
"2419","46111","Sanborn County, South Dakota",896,73,805,73,582,53,46,19,759,74,223,56,91,40
"2420","46115","Spink County, South Dakota",2459,108,2218,106,1846,120,156,48,2062,109,372,70,241,64
"2421","46117","Stanley County, South Dakota",1249,84,1093,93,959,96,97,62,996,112,134,55,156,72
"2422","46119","Sully County, South Dakota",578,51,526,54,425,50,46,21,480,55,101,30,52,22
"2423","46121","Todd County, South Dakota",2411,89,1553,148,1152,129,43,25,1510,153,401,88,858,118
"2424","46123","Tripp County, South Dakota",2101,127,1875,141,1468,148,169,63,1706,128,407,96,226,75
"2425","46125","Turner County, South Dakota",3467,87,3050,102,2548,104,240,63,2810,111,502,79,417,64
"2426","46127","Union County, South Dakota",6839,130,6281,171,5510,189,178,62,6103,183,771,154,558,115
"2427","46129","Walworth County, South Dakota",2310,123,1927,150,1617,131,153,56,1774,154,310,97,383,91
"2428","46135","Yankton County, South Dakota",9657,350,8643,368,7373,380,631,157,8012,378,1270,217,1014,223
"2429","46137","Ziebach County, South Dakota",689,40,516,48,420,44,89,25,427,47,96,24,173,29
"2430","47001","Anderson County, Tennessee",30973,540,28211,568,22656,760,1216,253,26995,613,5555,651,2762,374
"2431","47003","Bedford County, Tennessee",17904,328,15804,476,12115,517,661,161,15143,473,3689,465,2100,409
"2432","47005","Benton County, Tennessee",6509,242,5514,241,4063,290,432,131,5082,281,1451,252,995,199
"2433","47007","Bledsoe County, Tennessee",4901,260,4017,238,3009,265,211,92,3806,231,1008,232,884,244
"2434","47009","Blount County, Tennessee",52337,704,47969,830,39559,865,1888,251,46081,881,8410,656,4368,447
"2435","47011","Bradley County, Tennessee",40948,550,37575,754,30094,854,1722,380,35853,808,7481,723,3373,577
"2436","47013","Campbell County, Tennessee",15744,546,13536,570,9532,552,601,181,12935,583,4004,429,2208,323
"2437","47015","Cannon County, Tennessee",5671,201,5079,239,3861,269,322,140,4757,244,1218,253,592,139
"2438","47017","Carroll County, Tennessee",10988,341,9215,339,7123,437,577,145,8638,312,2092,270,1773,265
"2439","47019","Carter County, Tennessee",23547,365,20143,450,15231,619,1633,293,18510,478,4912,544,3404,396
"2440","47021","Cheatham County, Tennessee",15366,313,14100,354,11286,472,754,252,13346,342,2814,389,1266,263
"2441","47023","Chester County, Tennessee",6108,279,5244,359,3461,340,155,75,5089,372,1783,313,864,230
"2442","47025","Claiborne County, Tennessee",13410,341,11227,398,7688,388,591,146,10636,417,3539,389,2183,283
"2443","47027","Clay County, Tennessee",2973,189,2420,226,1707,203,229,92,2191,228,713,177,553,135
"2444","47029","Cocke County, Tennessee",14339,413,11919,471,7923,618,642,235,11277,462,3996,495,2420,285
"2445","47031","Coffee County, Tennessee",22417,348,19797,499,15109,578,1029,229,18768,550,4688,588,2620,390
"2446","47033","Crockett County, Tennessee",5387,138,4622,189,3276,235,215,99,4407,204,1346,185,765,141
"2447","47035","Cumberland County, Tennessee",26523,391,24192,509,19667,658,1733,292,22459,557,4525,592,2331,347
"2448","47037","Davidson County, Tennessee",293859,1684,278793,1917,237814,2634,8014,720,270779,1858,40979,1896,15066,911
"2449","47039","Decatur County, Tennessee",4375,235,3590,249,2645,258,219,80,3371,257,945,195,785,160
"2450","47041","DeKalb County, Tennessee",8023,291,6752,361,5190,375,321,107,6431,367,1562,284,1271,253
"2451","47043","Dickson County, Tennessee",19663,398,17666,476,14522,533,836,200,16830,507,3144,419,1997,316
"2452","47045","Dyer County, Tennessee",14659,339,13011,417,10008,449,692,167,12319,453,3003,444,1648,305
"2453","47047","Fayette County, Tennessee",15932,298,14548,339,11318,380,764,184,13784,351,3230,345,1384,254
"2454","47049","Fentress County, Tennessee",7443,305,6164,342,4377,314,521,153,5643,331,1787,324,1279,258
"2455","47051","Franklin County, Tennessee",16467,317,14387,482,10959,497,862,234,13525,509,3428,411,2080,384
"2456","47053","Gibson County, Tennessee",19436,434,17010,498,12388,649,897,210,16113,516,4622,539,2426,326
"2457","47055","Giles County, Tennessee",11395,363,10203,378,7546,444,729,199,9474,390,2657,332,1192,198
"2458","47057","Grainger County, Tennessee",9343,234,7985,315,5516,367,442,134,7543,327,2469,329,1358,224
"2459","47059","Greene County, Tennessee",27468,610,23459,653,16905,694,1499,309,21960,634,6554,593,4009,445
"2460","47061","Grundy County, Tennessee",4833,168,4011,181,3121,214,255,77,3756,173,890,159,822,133
"2461","47063","Hamblen County, Tennessee",24471,403,21589,511,16423,697,1449,302,20140,551,5166,592,2882,395
"2462","47065","Hamilton County, Tennessee",147419,1099,135608,1362,112520,1444,4547,497,131061,1257,23088,1073,11811,895
"2463","47067","Hancock County, Tennessee",2852,154,2208,163,1441,161,191,93,2017,166,767,130,644,131
"2464","47069","Hardeman County, Tennessee",9058,450,7693,461,4729,400,331,100,7362,457,2964,328,1365,259
"2465","47071","Hardin County, Tennessee",10787,356,8999,470,6019,461,293,114,8706,447,2980,394,1788,373
"2466","47073","Hawkins County, Tennessee",22777,519,19919,614,14557,670,1288,230,18631,643,5362,599,2858,409
"2467","47075","Haywood County, Tennessee",7118,230,5870,246,3828,287,330,115,5540,235,2042,295,1248,200
"2468","47077","Henderson County, Tennessee",10823,275,8990,381,6309,410,399,148,8591,382,2681,326,1833,299
"2469","47079","Henry County, Tennessee",12938,355,11298,400,8296,467,697,163,10601,417,3002,376,1640,258
"2470","47081","Hickman County, Tennessee",8736,343,7277,356,5483,374,355,114,6922,360,1794,289,1459,271
"2471","47083","Houston County, Tennessee",2860,155,2322,170,1737,161,199,57,2123,175,585,124,538,84
"2472","47085","Humphreys County, Tennessee",6688,248,5695,274,4439,262,462,128,5233,276,1256,211,993,186
"2473","47087","Jackson County, Tennessee",4523,187,3614,240,2624,267,316,108,3298,220,990,218,909,205
"2474","47089","Jefferson County, Tennessee",20419,518,18415,559,13526,652,666,195,17749,571,4889,485,2004,327
"2475","47091","Johnson County, Tennessee",6859,336,5604,352,4489,341,884,205,4720,334,1115,236,1255,260
"2476","47093","Knox County, Tennessee",192077,1185,179143,1396,150667,1902,5799,583,173344,1411,28476,1331,12934,869
"2477","47095","Lake County, Tennessee",2071,200,1656,190,1015,158,98,48,1558,183,641,136,415,95
"2478","47097","Lauderdale County, Tennessee",9144,282,7862,344,5320,345,495,129,7367,326,2542,275,1282,208
"2479","47099","Lawrence County, Tennessee",16483,276,14187,410,10531,537,623,117,13564,416,3656,469,2296,246
"2480","47101","Lewis County, Tennessee",4842,236,3756,283,2665,299,167,114,3589,296,1091,307,1086,255
"2481","47103","Lincoln County, Tennessee",14032,319,12366,434,8760,453,804,202,11562,449,3606,369,1666,316
"2482","47105","Loudon County, Tennessee",21801,413,20014,500,16068,684,1027,264,18987,518,3946,517,1787,330
"2483","47107","McMinn County, Tennessee",21163,457,18906,536,13700,578,806,201,18100,570,5206,459,2257,317
"2484","47109","McNairy County, Tennessee",9818,341,8423,349,5722,348,515,126,7908,367,2701,245,1395,208
"2485","47111","Macon County, Tennessee",9266,293,7821,340,5523,317,406,152,7415,378,2298,349,1445,304
"2486","47113","Madison County, Tennessee",38699,570,34575,612,26682,726,1402,231,33173,603,7893,692,4124,509
"2487","47115","Marion County, Tennessee",11718,303,10271,393,7634,395,369,116,9902,381,2637,353,1447,230
"2488","47117","Marshall County, Tennessee",12718,283,11661,308,8965,393,637,173,11024,368,2696,313,1057,227
"2489","47119","Maury County, Tennessee",38532,587,36418,639,31163,717,1252,233,35166,653,5255,519,2114,333
"2490","47121","Meigs County, Tennessee",5129,235,4473,252,3137,252,131,47,4342,256,1336,206,656,137
"2491","47123","Monroe County, Tennessee",18574,409,15719,559,11584,569,641,181,15078,575,4135,473,2855,447
"2492","47125","Montgomery County, Tennessee",77460,642,74456,783,64277,1140,2434,457,72022,1006,10179,997,3004,433
"2493","47127","Moore County, Tennessee",2475,134,2181,143,1525,176,93,67,2088,145,656,143,294,104
"2494","47129","Morgan County, Tennessee",7110,297,5913,354,4385,337,307,93,5606,362,1528,258,1197,225
"2495","47131","Obion County, Tennessee",12526,261,10638,289,7568,344,771,181,9867,307,3070,333,1888,234
"2496","47133","Overton County, Tennessee",8731,287,7078,295,5462,336,416,129,6662,290,1616,287,1653,213
"2497","47135","Perry County, Tennessee",3052,234,2323,244,1638,238,276,115,2047,253,685,181,729,188
"2498","47137","Pickett County, Tennessee",2161,204,1737,225,1421,212,253,108,1484,226,316,106,424,113
"2499","47139","Polk County, Tennessee",7006,274,5762,305,4251,275,290,80,5472,308,1511,282,1244,264
"2500","47141","Putnam County, Tennessee",31933,484,28793,712,24444,810,1255,255,27538,694,4349,496,3140,531
"2501","47143","Rhea County, Tennessee",12756,367,11425,403,8687,462,459,162,10966,405,2738,344,1331,262
"2502","47145","Roane County, Tennessee",21773,491,19767,584,15235,706,663,171,19104,637,4532,538,2006,327
"2503","47147","Robertson County, Tennessee",26536,352,24304,492,19101,526,588,123,23716,495,5203,573,2232,348
"2504","47149","Rutherford County, Tennessee",118955,943,114311,1080,99851,1353,2649,428,111662,1154,14460,990,4644,549
"2505","47151","Scott County, Tennessee",8533,286,7082,344,4689,385,310,145,6772,336,2393,290,1451,264
"2506","47153","Sequatchie County, Tennessee",5866,230,5175,218,4127,321,359,135,4816,230,1048,235,691,143
"2507","47155","Sevier County, Tennessee",36817,832,33198,825,25924,975,1162,245,32036,815,7274,758,3619,552
"2508","47157","Shelby County, Tennessee",354736,1816,318222,2150,248916,2705,9981,792,308241,2199,69306,2242,36514,1516
"2509","47159","Smith County, Tennessee",7473,203,6638,221,5221,277,340,101,6298,218,1417,214,835,159
"2510","47161","Stewart County, Tennessee",5091,262,4291,264,3362,276,212,90,4079,261,929,188,800,178
"2511","47163","Sullivan County, Tennessee",67025,626,59786,820,48562,882,3576,377,56210,833,11224,716,7239,557
"2512","47165","Sumner County, Tennessee",72638,592,68786,746,58345,866,2555,506,66231,840,10441,708,3852,471
"2513","47167","Tipton County, Tennessee",21860,338,20028,409,15212,538,724,183,19304,397,4816,471,1832,298
"2514","47169","Trousdale County, Tennessee",3349,518,2849,513,2044,484,76,57,2773,514,805,257,500,128
"2515","47171","Unicoi County, Tennessee",7583,249,6308,289,5180,318,459,149,5849,290,1128,235,1275,243
"2516","47173","Union County, Tennessee",7411,324,6613,358,4515,383,349,168,6264,378,2098,270,798,199
"2517","47175","Van Buren County, Tennessee",2412,123,1892,154,1443,147,76,41,1816,163,449,128,520,115
"2518","47177","Warren County, Tennessee",15790,374,13554,436,10159,431,666,151,12888,441,3395,433,2236,297
"2519","47179","Washington County, Tennessee",54913,741,49647,825,41187,937,1842,309,47805,794,8460,712,5266,528
"2520","47181","Wayne County, Tennessee",5671,258,4653,283,3290,296,184,75,4469,277,1363,245,1018,191
"2521","47183","Weakley County, Tennessee",13213,379,11133,511,8435,601,706,188,10427,512,2698,370,2080,308
"2522","47185","White County, Tennessee",10306,302,8848,347,6698,398,721,199,8127,364,2150,306,1458,273
"2523","47187","Williamson County, Tennessee",85311,576,83340,674,79116,796,1559,331,81781,760,4224,559,1971,350
"2524","47189","Wilson County, Tennessee",52983,651,50245,777,43642,961,1519,278,48726,774,6603,707,2738,449
"2525","48001","Anderson County, Texas",16477,560,14574,582,10602,621,634,253,13940,653,3972,498,1903,332
"2526","48003","Andrews County, Texas",6263,211,5912,248,4363,396,142,90,5770,251,1549,320,351,144
"2527","48005","Angelina County, Texas",31151,566,28587,578,22094,761,1279,294,27308,572,6493,581,2564,379
"2528","48007","Aransas County, Texas",10452,564,9823,544,7955,546,709,246,9114,577,1868,405,629,247
"2529","48009","Archer County, Texas",3371,101,3035,125,2363,138,181,67,2854,131,672,117,336,81
"2530","48011","Armstrong County, Texas",708,69,656,76,562,73,19,14,637,75,94,38,52,35
"2531","48013","Atascosa County, Texas",15899,458,14471,498,10156,565,335,137,14136,532,4315,503,1428,294
"2532","48015","Austin County, Texas",11841,363,11000,366,8499,408,403,135,10597,391,2501,390,841,236
"2533","48017","Bailey County, Texas",1952,240,1716,270,1266,268,42,47,1674,271,450,162,236,137
"2534","48019","Bandera County, Texas",8383,311,7901,356,6839,372,618,244,7283,399,1062,206,482,198
"2535","48021","Bastrop County, Texas",31271,666,28821,740,23419,721,1326,310,27495,763,5402,598,2450,443
"2536","48023","Baylor County, Texas",1509,128,1290,128,1084,141,48,41,1242,125,206,77,219,103
"2537","48025","Bee County, Texas",8497,436,7492,465,5570,395,291,102,7201,476,1922,281,1005,236
"2538","48027","Bell County, Texas",130523,1020,123016,1202,106693,1446,5050,693,117966,1390,16323,1096,7507,739
"2539","48029","Bexar County, Texas",717124,2098,676868,2676,547749,4024,18266,1074,658602,2860,129119,3298,40256,1619
"2540","48031","Blanco County, Texas",4749,216,4477,237,3634,282,150,62,4327,239,843,189,272,95
"2541","48033","Borden County, Texas",196,38,181,37,165,36,4,4,177,35,16,9,15,11
"2542","48035","Bosque County, Texas",7037,187,6178,223,4856,229,312,111,5866,240,1322,252,859,165
"2543","48037","Bowie County, Texas",33983,546,28332,788,22673,832,1450,283,26882,771,5659,561,5651,631
"2544","48039","Brazoria County, Texas",124284,1242,118429,1376,102438,1632,2865,521,115564,1474,15991,995,5855,671
"2545","48041","Brazos County, Texas",83627,1056,80288,1128,68846,1392,1647,312,78641,1172,11442,874,3339,436
"2546","48043","Brewster County, Texas",4706,201,4239,231,3125,245,268,132,3971,260,1114,225,467,155
"2547","48045","Briscoe County, Texas",557,76,447,68,350,59,32,17,415,66,97,40,110,50
"2548","48047","Brooks County, Texas",2425,261,1829,242,936,204,30,32,1799,246,893,279,596,181
"2549","48049","Brown County, Texas",14651,368,13153,397,9942,460,597,123,12556,395,3211,399,1498,221
"2550","48051","Burleson County, Texas",7178,289,6226,354,4657,373,310,116,5916,357,1569,274,952,221
"2551","48053","Burnet County, Texas",17941,534,17083,517,14532,514,997,242,16086,521,2551,398,858,248
"2552","48055","Caldwell County, Texas",14315,361,13060,449,9501,535,479,156,12581,450,3559,422,1255,266
"2553","48057","Calhoun County, Texas",7748,277,6981,321,5375,330,236,90,6745,315,1606,288,767,214
"2554","48059","Callahan County, Texas",5247,246,4771,258,3817,232,282,97,4489,252,954,203,476,110
"2555","48061","Cameron County, Texas",130030,968,111250,1184,78102,1470,2664,419,108586,1262,33148,1518,18780,961
"2556","48063","Camp County, Texas",4385,262,3946,277,2750,277,211,82,3735,259,1196,205,439,129
"2557","48065","Carson County, Texas",2282,103,2050,128,1650,150,120,55,1930,137,400,122,232,89
"2558","48067","Cass County, Texas",11371,306,9785,405,6453,416,420,100,9365,406,3332,342,1586,243
"2559","48069","Castro County, Texas",2417,134,2163,128,1326,148,34,24,2129,133,837,122,254,75
"2560","48071","Chambers County, Texas",14905,455,14258,502,11665,654,379,186,13879,530,2593,539,647,188
"2561","48073","Cherokee County, Texas",18173,353,16237,417,11964,532,651,160,15586,459,4273,514,1936,272
"2562","48075","Childress County, Texas",2070,205,1791,223,1384,229,75,64,1716,230,407,137,279,123
"2563","48077","Clay County, Texas",4119,150,3711,204,3116,194,225,79,3486,192,595,106,408,126
"2564","48079","Cochran County, Texas",973,63,849,73,483,70,31,20,818,74,366,77,124,31
"2565","48081","Coke County, Texas",1384,94,1184,117,832,89,63,27,1121,121,352,94,200,85
"2566","48083","Coleman County, Texas",3222,217,2743,220,2048,249,131,67,2612,213,695,162,479,136
"2567","48085","Collin County, Texas",369168,1287,363501,1412,338435,1893,5478,574,358023,1481,25066,1592,5667,665
"2568","48087","Collingsworth County, Texas",1053,104,955,111,594,97,17,13,938,111,361,86,98,46
"2569","48089","Colorado County, Texas",6999,335,5883,326,4524,348,332,109,5551,339,1359,245,1116,298
"2570","48091","Comal County, Texas",60714,694,58354,783,53035,930,1694,360,56660,789,5319,667,2360,395
"2571","48093","Comanche County, Texas",5138,217,4564,249,3544,275,336,101,4228,238,1020,170,574,144
"2572","48095","Concho County, Texas",803,156,710,132,572,118,51,30,659,131,138,50,93,44
"2573","48097","Cooke County, Texas",16106,300,14259,452,10872,511,574,166,13685,465,3387,420,1847,360
"2574","48099","Coryell County, Texas",23954,664,22384,677,18921,724,871,211,21513,684,3463,501,1570,289
"2575","48101","Cottle County, Texas",654,103,542,83,432,73,19,14,523,85,110,45,112,70
"2576","48103","Crane County, Texas",1614,73,1564,84,880,173,80,58,1484,100,684,174,50,37
"2577","48105","Crockett County, Texas",1297,176,1152,194,895,193,14,10,1138,192,257,113,145,107
"2578","48107","Crosby County, Texas",1934,99,1709,99,1201,117,62,31,1647,100,508,84,225,55
"2579","48109","Culberson County, Texas",634,194,368,129,241,104,0,14,368,129,127,71,266,126
"2580","48111","Dallam County, Texas",2367,219,2103,216,1653,212,16,17,2087,217,450,192,264,114
"2581","48113","Dallas County, Texas",947046,2388,887403,3396,728034,4210,23803,1283,863600,3272,159369,3349,59643,1968
"2582","48115","Dawson County, Texas",4214,238,3627,246,2133,206,97,49,3530,243,1494,226,587,142
"2583","48117","Deaf Smith County, Texas",6064,217,5479,254,3505,322,123,59,5356,246,1974,291,585,172
"2584","48119","Delta County, Texas",2057,106,1837,120,1447,160,85,38,1752,113,390,130,220,97
"2585","48121","Denton County, Texas",321447,1348,316056,1437,289630,1996,5116,556,310940,1521,26426,1600,5391,614
"2586","48123","DeWitt County, Texas",6610,266,5541,289,4042,255,247,77,5294,287,1499,235,1069,177
"2587","48125","Dickens County, Texas",635,68,575,68,430,62,56,24,519,74,145,49,60,30
"2588","48127","Dimmit County, Texas",2902,229,2078,248,1660,243,42,57,2036,252,418,150,824,228
"2589","48129","Donley County, Texas",1193,111,1095,127,707,95,49,23,1046,131,388,109,98,39
"2590","48131","Duval County, Texas",2842,184,2246,187,1396,157,183,94,2063,204,850,185,596,122
"2591","48133","Eastland County, Texas",6697,334,5806,357,4361,362,306,108,5500,383,1445,271,891,195
"2592","48135","Ector County, Texas",59019,730,55258,856,38630,1157,1426,347,53832,934,16628,1180,3761,545
"2593","48137","Edwards County, Texas",558,137,404,120,296,100,51,43,353,114,108,84,154,85
"2594","48139","Ellis County, Texas",62708,512,60146,689,51509,1087,1721,342,58425,726,8637,781,2562,418
"2595","48141","El Paso County, Texas",288186,1292,261994,1683,206117,2358,6958,613,255036,1754,55877,1945,26192,1345
"2596","48143","Erath County, Texas",14926,497,14170,522,11337,563,632,214,13538,540,2833,520,756,196
"2597","48145","Falls County, Texas",5419,291,4034,324,3115,281,203,80,3831,312,919,183,1385,220
"2598","48147","Fannin County, Texas",12470,291,11132,354,8572,409,409,101,10723,360,2560,355,1338,226
"2599","48149","Fayette County, Texas",8720,267,7202,296,6002,319,454,134,6748,325,1200,223,1518,224
"2600","48151","Fisher County, Texas",1533,129,1266,110,932,96,33,16,1233,108,334,86,267,62
"2601","48153","Floyd County, Texas",1894,124,1670,119,1163,125,88,43,1582,131,507,113,224,90
"2602","48155","Foard County, Texas",471,75,389,73,275,75,64,35,325,69,114,45,82,46
"2603","48157","Fort Bend County, Texas",259106,1248,252055,1356,234198,1937,5292,776,246763,1570,17857,1497,7051,837
"2604","48159","Franklin County, Texas",3546,241,3289,254,2679,276,205,119,3084,240,610,170,257,110
"2605","48161","Freestone County, Texas",6567,274,5651,297,4379,343,309,121,5342,284,1272,238,916,161
"2606","48163","Frio County, Texas",4763,401,3898,408,2426,450,199,155,3699,422,1472,401,865,212
"2607","48165","Gaines County, Texas",6775,205,5726,301,3917,376,120,90,5606,304,1809,361,1049,259
"2608","48167","Galveston County, Texas",131877,883,125292,1105,105364,1394,3592,425,121700,1195,19928,1126,6585,693
"2609","48169","Garza County, Texas",1705,187,1594,184,1165,180,107,66,1487,178,429,133,111,66
"2610","48171","Gillespie County, Texas",11205,407,10315,490,8745,479,622,172,9693,486,1570,302,890,200
"2611","48173","Glasscock County, Texas",457,76,432,73,329,59,24,19,408,74,103,65,25,27
"2612","48175","Goliad County, Texas",2671,161,2170,148,1582,188,99,54,2071,159,588,168,501,125
"2613","48177","Gonzales County, Texas",7496,232,6536,255,4239,300,170,64,6366,256,2297,243,960,190
"2614","48179","Gray County, Texas",7881,292,7267,336,5122,374,355,102,6912,335,2145,305,614,141
"2615","48181","Grayson County, Texas",51021,610,47199,715,37259,1016,2309,423,44890,827,9940,734,3822,449
"2616","48183","Gregg County, Texas",46654,762,43111,818,32167,928,1387,205,41724,831,10944,833,3543,467
"2617","48185","Grimes County, Texas",9469,1007,8498,1036,6711,812,354,194,8144,928,1787,353,971,199
"2618","48187","Guadalupe County, Texas",58439,637,55415,763,46717,843,1559,299,53856,782,8698,612,3024,472
"2619","48189","Hale County, Texas",11070,327,9796,309,6399,391,292,93,9504,318,3397,397,1274,242
"2620","48191","Hall County, Texas",1132,97,938,100,646,90,123,60,815,110,292,68,194,52
"2621","48193","Hamilton County, Texas",2910,186,2579,217,1989,190,211,88,2368,220,590,144,331,146
"2622","48195","Hansford County, Texas",1764,122,1565,160,1225,170,42,37,1523,157,340,131,199,100
"2623","48197","Hardeman County, Texas",1222,106,1091,106,783,88,60,30,1031,108,308,81,131,47
"2624","48199","Hardin County, Texas",20568,512,18807,535,14516,660,670,201,18137,608,4291,575,1761,340
"2625","48201","Harris County, Texas",1658503,3652,1569889,4160,1287010,6161,39446,2179,1530443,4219,282879,4542,88614,2385
"2626","48203","Harrison County, Texas",24276,556,21762,619,16683,637,917,237,20845,626,5079,638,2514,366
"2627","48205","Hartley County, Texas",1704,120,1672,125,1462,119,35,37,1637,131,210,95,32,30
"2628","48207","Haskell County, Texas",2030,134,1777,134,1223,139,131,45,1646,138,554,94,253,84
"2629","48209","Hays County, Texas",84924,882,81728,931,72939,1258,1647,417,80081,986,8789,1020,3196,605
"2630","48211","Hemphill County, Texas",1387,102,1301,112,863,105,22,20,1279,113,438,115,86,47
"2631","48213","Henderson County, Texas",31267,703,28003,712,21140,836,1279,214,26724,713,6863,549,3264,413
"2632","48215","Hidalgo County, Texas",251916,1868,225397,2397,152749,2592,4872,662,220525,2454,72648,2268,26519,1469
"2633","48217","Hill County, Texas",13043,275,11841,327,8867,398,544,103,11297,359,2974,333,1202,186
"2634","48219","Hockley County, Texas",7935,206,7096,218,4922,261,146,49,6950,222,2174,229,839,140
"2635","48221","Hood County, Texas",24195,544,23320,574,20086,650,1045,233,22275,607,3234,493,875,236
"2636","48223","Hopkins County, Texas",13746,270,12763,282,9471,409,569,156,12194,310,3292,345,983,150
"2637","48225","Houston County, Texas",7353,356,6250,317,4399,321,361,105,5889,317,1851,253,1103,185
"2638","48227","Howard County, Texas",12062,302,11243,379,8309,410,423,157,10820,382,2934,415,819,176
"2639","48229","Hudspeth County, Texas",869,92,710,117,435,100,70,57,640,119,275,87,159,76
"2640","48231","Hunt County, Texas",35756,522,32976,585,26071,686,1072,237,31904,588,6905,583,2780,326
"2641","48233","Hutchinson County, Texas",6881,261,6174,257,4593,285,308,115,5866,251,1581,254,707,164
"2642","48235","Irion County, Texas",677,68,580,79,404,79,32,24,548,82,176,58,97,46
"2643","48237","Jack County, Texas",2914,172,2701,173,1808,205,103,45,2598,178,893,151,213,80
"2644","48239","Jackson County, Texas",5155,258,4717,272,3397,306,149,74,4568,267,1320,230,438,130
"2645","48241","Jasper County, Texas",12776,407,11219,454,5124,457,265,95,10954,463,6095,502,1557,247
"2646","48243","Jeff Davis County, Texas",1010,161,867,115,756,120,66,69,801,119,111,94,143,130
"2647","48245","Jefferson County, Texas",92751,1113,86607,1294,61001,1422,2295,378,84312,1293,25606,1325,6144,589
"2648","48247","Jim Hogg County, Texas",1423,207,1158,204,589,146,74,65,1084,202,569,182,265,89
"2649","48249","Jim Wells County, Texas",12835,384,9946,635,7882,619,1583,370,8363,629,2064,312,2889,546
"2650","48251","Johnson County, Texas",60915,598,57196,700,47794,950,1436,236,55760,745,9402,770,3719,486
"2651","48253","Jones County, Texas",5792,381,5164,373,3839,388,216,86,4948,377,1325,244,628,144
"2652","48255","Karnes County, Texas",4431,381,3910,372,2678,291,231,144,3679,397,1232,288,521,106
"2653","48257","Kaufman County, Texas",46189,540,44049,590,36602,744,995,205,43054,643,7447,797,2140,351
"2654","48259","Kendall County, Texas",16261,379,15942,392,14574,513,436,134,15506,415,1368,346,319,140
"2655","48261","Kenedy County, Texas",48,37,25,25,21,23,0,14,25,25,4,8,23,25
"2656","48263","Kent County, Texas",243,53,226,53,185,50,3,3,223,52,41,20,17,16
"2657","48265","Kerr County, Texas",21842,448,20569,487,17399,578,1152,194,19417,521,3170,356,1273,242
"2658","48267","Kimble County, Texas",1797,139,1555,148,1170,138,132,83,1423,155,385,105,242,89
"2659","48269","King County, Texas",83,26,83,26,74,26,4,6,79,26,9,7,0,14
"2660","48271","Kinney County, Texas",1039,162,734,159,650,164,38,42,696,156,84,56,305,150
"2661","48273","Kleberg County, Texas",11559,428,10420,490,7894,522,171,103,10249,484,2526,420,1139,249
"2662","48275","Knox County, Texas",1251,94,1080,99,818,100,53,23,1027,105,262,68,171,58
"2663","48277","Lamar County, Texas",19930,427,17691,517,12611,545,864,259,16827,522,5080,498,2239,301
"2664","48279","Lamb County, Texas",4604,162,3860,196,2796,185,154,58,3706,190,1064,145,744,135
"2665","48281","Lampasas County, Texas",7928,342,7391,350,6071,355,313,101,7078,356,1320,208,537,157
"2666","48283","La Salle County, Texas",1868,219,1668,212,1203,241,40,58,1628,209,465,184,200,112
"2667","48285","Lavaca County, Texas",8012,242,6626,258,5108,236,392,111,6234,255,1518,208,1386,193
"2668","48287","Lee County, Texas",6148,277,5443,337,4184,362,237,112,5206,362,1259,281,705,210
"2669","48289","Leon County, Texas",6136,347,5425,349,3901,323,492,194,4933,371,1524,293,711,175
"2670","48291","Liberty County, Texas",27688,606,25436,699,17419,963,750,195,24686,718,8017,805,2252,370
"2671","48293","Limestone County, Texas",8027,281,6661,350,4700,367,220,66,6441,353,1961,297,1366,224
"2672","48295","Lipscomb County, Texas",1144,78,1076,77,846,76,34,15,1042,77,230,51,68,28
"2673","48297","Live Oak County, Texas",3857,217,3067,254,2237,218,324,96,2743,253,830,203,790,165
"2674","48299","Llano County, Texas",9220,352,8569,332,7505,352,501,145,8068,347,1064,234,651,178
"2675","48301","Loving County, Texas",33,26,32,25,32,25,0,14,32,25,0,14,1,2
"2676","48303","Lubbock County, Texas",118704,960,111980,1074,89746,1555,2612,395,109368,1144,22234,1450,6724,618
"2677","48305","Lynn County, Texas",2104,94,1846,99,1364,110,33,19,1813,97,482,94,258,70
"2678","48307","McCulloch County, Texas",3138,227,2911,235,2249,221,303,91,2608,225,662,152,227,66
"2679","48309","McLennan County, Texas",94194,966,86764,1021,68383,1271,2828,381,83936,1027,18381,1100,7430,654
"2680","48311","McMullen County, Texas",186,52,164,49,103,42,6,9,158,49,61,28,22,15
"2681","48313","Madison County, Texas",3985,357,3490,354,2581,318,157,67,3333,354,909,202,495,172
"2682","48315","Marion County, Texas",4036,257,3409,263,2209,221,186,79,3223,268,1200,217,627,144
"2683","48317","Martin County, Texas",1868,86,1666,106,1253,148,72,59,1594,111,413,125,202,86
"2684","48319","Mason County, Texas",1490,108,1309,109,1022,120,57,49,1252,107,287,108,181,77
"2685","48321","Matagorda County, Texas",13686,440,12025,523,8441,613,413,145,11612,547,3584,562,1661,278
"2686","48323","Maverick County, Texas",17690,407,14506,504,9301,719,325,167,14181,524,5205,616,3184,453
"2687","48325","Medina County, Texas",16765,423,14978,489,11720,642,543,139,14435,503,3258,436,1787,332
"2688","48327","Menard County, Texas",904,126,774,125,441,99,44,35,730,121,333,110,130,72
"2689","48329","Midland County, Texas",63506,789,59947,897,48098,1280,1212,363,58735,943,11849,1262,3559,567
"2690","48331","Milam County, Texas",9740,281,8732,306,6045,352,444,122,8288,302,2687,361,1008,190
"2691","48333","Mills County, Texas",1695,143,1491,131,1237,126,47,31,1444,124,254,66,204,76
"2692","48335","Mitchell County, Texas",2258,323,1895,341,1222,353,96,91,1799,316,673,230,363,224
"2693","48337","Montague County, Texas",7835,279,6963,335,5312,373,287,108,6676,334,1651,269,872,178
"2694","48339","Montgomery County, Texas",214328,1559,208089,1880,180931,2334,4913,866,203176,2034,27158,1696,6239,786
"2695","48341","Moore County, Texas",6893,248,6384,289,4136,342,220,120,6164,314,2248,337,509,170
"2696","48343","Morris County, Texas",4784,236,4333,264,2721,250,260,129,4073,285,1612,251,451,144
"2697","48345","Motley County, Texas",458,62,404,65,351,58,21,14,383,65,53,24,54,25
"2698","48347","Nacogdoches County, Texas",24179,545,21935,610,16958,695,765,169,21170,623,4977,518,2244,330
"2699","48349","Navarro County, Texas",17602,347,15619,447,11507,536,729,222,14890,450,4112,389,1983,290
"2700","48351","Newton County, Texas",4728,243,4230,257,1745,199,176,83,4054,264,2485,283,498,159
"2701","48353","Nolan County, Texas",5548,239,4938,226,3199,256,265,84,4673,245,1739,250,610,142
"2702","48355","Nueces County, Texas",129845,961,119659,1219,88369,1476,3523,422,116136,1298,31290,1339,10186,922
"2703","48357","Ochiltree County, Texas",3605,185,3254,190,2554,191,209,101,3045,195,700,139,351,129
"2704","48359","Oldham County, Texas",648,92,613,89,488,73,23,13,590,88,125,39,35,19
"2705","48361","Orange County, Texas",30636,552,28655,603,22312,824,842,187,27813,622,6343,672,1981,248
"2706","48363","Palo Pinto County, Texas",10383,362,9618,414,7731,435,322,95,9296,435,1887,277,765,153
"2707","48365","Panola County, Texas",8186,340,6992,379,5616,408,271,94,6721,373,1376,279,1194,226
"2708","48367","Parker County, Texas",50815,537,48863,587,42412,735,1350,290,47513,613,6451,582,1952,312
"2709","48369","Parmer County, Texas",3172,121,2968,151,1931,167,81,44,2887,147,1037,169,204,84
"2710","48371","Pecos County, Texas",4995,269,4220,289,3117,317,138,99,4082,302,1103,252,775,185
"2711","48373","Polk County, Texas",17028,685,15567,727,12109,714,1388,323,14179,727,3458,435,1461,279
"2712","48375","Potter County, Texas",43103,630,39702,685,27191,862,1079,201,38623,668,12511,744,3401,448
"2713","48377","Presidio County, Texas",2195,258,1625,262,1288,203,90,73,1535,252,337,150,570,191
"2714","48379","Rains County, Texas",4585,240,4064,236,2996,256,242,106,3822,242,1068,212,521,132
"2715","48381","Randall County, Texas",54480,631,52092,715,43993,911,1859,294,50233,697,8099,715,2388,394
"2716","48383","Reagan County, Texas",1069,103,1044,101,771,101,67,42,977,111,273,99,25,20
"2717","48385","Real County, Texas",893,155,776,146,628,140,62,35,714,143,148,97,117,51
"2718","48387","Red River County, Texas",4591,210,3725,214,2755,254,296,91,3429,204,970,181,866,157
"2719","48389","Reeves County, Texas",4070,214,3305,255,2453,271,18,20,3287,255,852,254,765,147
"2720","48391","Refugio County, Texas",2189,162,1829,155,1236,171,57,31,1772,156,593,125,360,98
"2721","48393","Roberts County, Texas",310,43,282,41,266,39,12,14,270,38,16,10,28,21
"2722","48395","Robertson County, Texas",6310,214,5444,246,3990,295,277,100,5167,260,1454,221,866,208
"2723","48397","Rockwall County, Texas",35771,409,35060,447,32439,572,711,246,34349,526,2621,441,711,197
"2724","48399","Runnels County, Texas",3746,168,3242,193,2404,194,121,43,3121,185,838,138,504,98
"2725","48401","Rusk County, Texas",17656,533,15775,543,12070,524,691,172,15084,581,3705,353,1881,294
"2726","48403","Sabine County, Texas",4317,268,3937,276,3080,288,465,150,3472,277,857,191,380,123
"2727","48405","San Augustine County, Texas",3167,223,2676,237,1746,221,174,71,2502,240,930,203,491,137
"2728","48407","San Jacinto County, Texas",9451,435,8487,451,6248,490,430,168,8057,502,2239,482,964,222
"2729","48409","San Patricio County, Texas",23808,504,21078,539,16710,661,860,221,20218,508,4368,504,2730,393
"2730","48411","San Saba County, Texas",1960,162,1707,164,1324,157,140,55,1567,164,383,93,253,72
"2731","48413","Schleicher County, Texas",883,101,752,108,521,106,19,17,733,110,231,76,131,47
"2732","48415","Scurry County, Texas",5973,334,5589,370,4048,339,170,89,5419,376,1541,324,384,136
"2733","48417","Shackelford County, Texas",1269,72,1113,84,880,87,16,14,1097,80,233,67,156,53
"2734","48419","Shelby County, Texas",8898,275,7862,322,5506,363,385,85,7477,341,2356,330,1036,160
"2735","48421","Sherman County, Texas",810,93,723,93,508,87,24,26,699,90,215,62,87,40
"2736","48423","Smith County, Texas",81377,1073,77019,1110,53118,1413,2381,382,74638,1100,23901,1402,4358,495
"2737","48425","Somervell County, Texas",3227,188,2999,211,2605,236,144,74,2855,227,394,189,228,119
"2738","48427","Starr County, Texas",18599,437,15872,500,9545,588,146,73,15726,514,6327,572,2727,339
"2739","48429","Stephens County, Texas",3385,232,3171,226,2075,265,68,45,3103,225,1096,241,214,86
"2740","48431","Sterling County, Texas",397,60,357,57,294,54,0,14,357,57,63,32,40,31
"2741","48433","Stonewall County, Texas",472,57,405,52,329,51,25,19,380,51,76,33,67,34
"2742","48435","Sutton County, Texas",1124,171,975,155,637,137,13,18,962,157,338,101,149,71
"2743","48437","Swisher County, Texas",2477,167,2116,169,1438,178,100,52,2016,169,678,160,361,103
"2744","48439","Tarrant County, Texas",739804,2208,710499,2811,602196,4167,17758,1010,692741,3005,108303,3248,29305,1496
"2745","48441","Taylor County, Texas",53292,735,49178,821,39685,1046,1630,259,47548,865,9493,730,4114,514
"2746","48443","Terrell County, Texas",426,107,367,101,311,90,12,14,355,98,56,40,59,35
"2747","48445","Terry County, Texas",4082,237,3692,271,2186,255,115,54,3577,277,1506,246,390,131
"2748","48447","Throckmorton County, Texas",618,65,562,57,396,61,18,13,544,58,166,50,56,27
"2749","48449","Titus County, Texas",10654,265,9541,283,6138,354,270,95,9271,273,3403,315,1113,194
"2750","48451","Tom Green County, Texas",44814,656,41179,925,33204,1023,1580,287,39599,912,7975,758,3635,599
"2751","48453","Travis County, Texas",514227,2192,497936,2637,449414,3390,10140,851,487796,2644,48522,2311,16291,1124
"2752","48455","Trinity County, Texas",5879,269,5036,277,3427,251,237,82,4799,275,1609,247,843,160
"2753","48457","Tyler County, Texas",6525,292,5758,295,4210,295,377,148,5381,306,1548,245,767,178
"2754","48459","Upshur County, Texas",14576,327,13165,387,9920,477,664,189,12501,417,3245,416,1411,264
"2755","48461","Upton County, Texas",1422,99,1274,96,740,100,32,20,1242,96,534,104,148,54
"2756","48463","Uvalde County, Texas",8324,312,6714,392,5099,399,221,83,6493,392,1615,336,1610,319
"2757","48465","Val Verde County, Texas",16146,419,14245,451,10595,616,447,204,13798,479,3650,426,1901,276
"2758","48467","Van Zandt County, Texas",22047,511,19931,514,15363,600,1071,265,18860,601,4568,518,2116,435
"2759","48469","Victoria County, Texas",34219,481,31123,578,22342,760,999,251,30124,597,8781,710,3096,414
"2760","48471","Walker County, Texas",23780,1221,21592,1218,17107,1282,765,366,20827,1300,4485,799,2188,427
"2761","48473","Waller County, Texas",17286,443,16584,463,13170,672,498,324,16086,532,3414,571,702,254
"2762","48475","Ward County, Texas",4299,176,3787,214,2757,274,90,47,3697,214,1030,248,512,130
"2763","48477","Washington County, Texas",13906,483,11906,468,9594,558,632,165,11274,494,2312,421,2000,329
"2764","48479","Webb County, Texas",76207,743,68189,996,48711,1145,1574,357,66615,983,19478,988,8018,668
"2765","48481","Wharton County, Texas",14991,325,12834,393,8932,488,561,156,12273,414,3902,477,2157,272
"2766","48483","Wheeler County, Texas",1935,110,1701,116,1242,114,61,36,1640,117,459,96,234,90
"2767","48485","Wichita County, Texas",48173,747,43894,760,34456,910,1614,294,42280,768,9438,652,4279,430
"2768","48487","Wilbarger County, Texas",4586,270,4179,313,3085,274,185,77,3994,313,1094,234,407,130
"2769","48489","Willacy County, Texas",5372,235,4523,310,2767,272,175,87,4348,329,1756,322,849,207
"2770","48491","Williamson County, Texas",217780,1081,212660,1362,195846,1874,5014,643,207646,1439,16814,1180,5120,776
"2771","48493","Wilson County, Texas",16949,287,16013,323,13643,442,438,148,15575,339,2370,316,936,158
"2772","48495","Winkler County, Texas",2723,131,2378,159,1811,154,54,35,2324,159,567,145,345,145
"2773","48497","Wise County, Texas",23488,451,22290,483,18334,616,793,239,21497,537,3956,458,1198,267
"2774","48499","Wood County, Texas",17584,483,15884,480,12604,567,786,171,15098,497,3280,498,1700,256
"2775","48501","Yoakum County, Texas",2682,139,2558,165,1552,286,2,3,2556,165,1006,278,124,110
"2776","48503","Young County, Texas",7409,252,6737,333,4799,424,273,101,6464,318,1938,309,672,188
"2777","48505","Zapata County, Texas",4390,266,3534,316,1873,301,200,110,3334,320,1661,275,856,214
"2778","48507","Zavala County, Texas",3394,168,3023,220,1784,312,170,178,2853,272,1239,282,371,123
"2779","49001","Beaver County, Utah",2126,168,2024,154,1567,173,37,28,1987,145,457,140,102,53
"2780","49003","Box Elder County, Utah",18194,258,17308,335,15464,379,595,200,16713,394,1844,278,886,211
"2781","49005","Cache County, Utah",40362,408,39152,478,36361,557,954,191,38198,472,2791,326,1210,229
"2782","49007","Carbon County, Utah",7762,226,7028,240,5826,331,384,114,6644,237,1202,255,734,147
"2783","49009","Daggett County, Utah",197,51,184,49,171,47,6,10,178,48,13,12,13,11
"2784","49011","Davis County, Utah",109899,595,107077,686,99522,982,2205,314,104872,701,7555,691,2822,392
"2785","49013","Duchesne County, Utah",6223,147,5865,158,4823,193,241,54,5624,164,1042,147,358,65
"2786","49015","Emery County, Utah",3450,101,3199,116,2665,135,144,44,3055,121,534,117,251,68
"2787","49017","Garfield County, Utah",1823,134,1624,129,1453,120,68,30,1556,128,171,65,199,71
"2788","49019","Grand County, Utah",4271,203,4007,255,3443,256,171,77,3836,252,564,208,264,141
"2789","49021","Iron County, Utah",17736,357,17058,392,15065,485,412,134,16646,427,1993,288,678,180
"2790","49023","Juab County, Utah",3500,89,3322,119,2860,170,128,65,3194,130,462,117,178,79
"2791","49025","Kane County, Utah",3006,244,2875,238,2609,229,165,93,2710,236,266,108,131,87
"2792","49027","Millard County, Utah",4204,145,4045,153,3461,204,169,63,3876,166,584,161,159,58
"2793","49029","Morgan County, Utah",3504,99,3446,107,3256,128,57,51,3389,116,190,74,58,33
"2794","49031","Piute County, Utah",538,69,426,64,357,54,23,15,403,64,69,28,112,53
"2795","49033","Rich County, Utah",661,88,657,87,576,75,19,15,638,86,81,39,4,4
"2796","49035","Salt Lake County, Utah",399584,1388,387170,1526,349751,2432,10474,1018,376696,1726,37419,1833,12414,821
"2797","49037","San Juan County, Utah",4438,145,3282,194,2554,180,162,93,3120,196,728,153,1156,162
"2798","49039","Sanpete County, Utah",8612,300,8276,309,7392,337,264,73,8012,308,884,196,336,99
"2799","49041","Sevier County, Utah",7250,156,6938,159,5959,210,295,77,6643,175,979,176,312,82
"2800","49043","Summit County, Utah",13475,418,13132,412,12474,368,264,107,12868,425,658,137,343,110
"2801","49045","Tooele County, Utah",21347,285,20773,309,18506,505,648,226,20125,364,2267,392,574,174
"2802","49047","Uintah County, Utah",11227,347,10245,410,8579,454,361,120,9884,422,1666,291,982,235
"2803","49049","Utah County, Utah",179387,739,176699,785,166666,1003,3210,383,173489,805,10033,646,2688,454
"2804","49051","Wasatch County, Utah",10641,365,10405,366,9752,419,148,91,10257,387,653,184,236,99
"2805","49053","Washington County, Utah",61377,1000,58261,1100,52571,1237,2290,325,55971,1064,5690,704,3116,532
"2806","49055","Wayne County, Utah",1055,99,998,104,871,94,91,44,907,112,127,59,57,39
"2807","49057","Weber County, Utah",87802,669,84390,692,75086,796,2371,349,82019,803,9304,733,3412,418
"2808","50001","Addison County, Vermont",14468,293,13544,319,11951,365,1201,151,12343,357,1593,212,924,148
"2809","50003","Bennington County, Vermont",14513,356,13217,342,11810,379,1383,235,11834,405,1407,278,1296,206
"2810","50005","Caledonia County, Vermont",12525,289,11119,291,9509,359,962,143,10157,277,1610,263,1406,195
"2811","50007","Chittenden County, Vermont",68146,579,64668,842,59347,951,2727,352,61941,877,5321,604,3478,571
"2812","50009","Essex County, Vermont",2729,103,2351,103,2050,111,363,69,1988,119,301,62,378,61
"2813","50011","Franklin County, Vermont",19073,383,17050,508,14916,522,1154,184,15896,502,2134,336,2023,296
"2814","50013","Grand Isle County, Vermont",2925,150,2724,151,2557,145,166,54,2558,159,167,48,201,72
"2815","50015","Lamoille County, Vermont",10830,330,10231,364,8545,398,662,158,9569,376,1686,267,599,142
"2816","50017","Orange County, Vermont",12383,221,11234,241,9795,290,1013,137,10221,266,1439,224,1149,160
"2817","50019","Orleans County, Vermont",11338,272,10068,317,8687,295,1066,154,9002,330,1381,158,1270,156
"2818","50021","Rutland County, Vermont",24998,428,22792,439,20033,496,2342,274,20450,457,2759,344,2206,298
"2819","50023","Washington County, Vermont",25137,389,23271,435,20805,510,1709,275,21562,519,2466,433,1866,268
"2820","50025","Windham County, Vermont",19085,389,17507,435,16164,460,2030,271,15477,485,1343,208,1578,242
"2821","50027","Windsor County, Vermont",24364,485,22578,529,20140,605,2217,350,20361,568,2438,369,1786,260
"2822","51001","Accomack County, Virginia",14152,483,11892,533,9016,498,800,179,11092,555,2876,387,2260,365
"2823","51003","Albemarle County, Virginia",43066,825,40968,909,37211,985,1996,389,38972,920,3757,526,2098,329
"2824","51005","Alleghany County, Virginia",6405,206,5473,260,3903,254,498,134,4975,265,1570,258,932,235
"2825","51007","Amelia County, Virginia",5190,227,4428,269,3324,292,276,110,4152,271,1104,247,762,183
"2826","51009","Amherst County, Virginia",12538,346,10949,361,8538,441,701,165,10248,365,2411,337,1589,261
"2827","51011","Appomattox County, Virginia",6187,243,5466,254,4275,273,250,95,5216,260,1191,229,721,149
"2828","51013","Arlington County, Virginia",109528,819,105858,908,100461,963,2327,364,103531,967,5397,528,3670,488
"2829","51015","Augusta County, Virginia",29880,499,26833,669,21333,796,1513,292,25320,668,5500,581,3047,436
"2830","51017","Bath County, Virginia",1823,181,1521,161,1046,204,123,88,1398,190,475,178,302,144
"2831","51019","Bedford County, Virginia",32269,464,29713,498,25156,604,1402,259,28311,558,4557,487,2556,360
"2832","51021","Bland County, Virginia",2260,212,1764,186,1119,165,87,43,1677,180,645,182,496,138
"2833","51023","Botetourt County, Virginia",13076,280,11570,424,9732,458,511,137,11059,442,1838,312,1506,313
"2834","51025","Brunswick County, Virginia",5905,314,5008,321,3498,275,209,94,4799,320,1510,273,897,164
"2835","51027","Buchanan County, Virginia",7440,371,5933,442,4302,412,508,140,5425,431,1631,297,1507,260
"2836","51029","Buckingham County, Virginia",5724,244,4634,285,3362,249,341,98,4293,271,1272,183,1090,214
"2837","51031","Campbell County, Virginia",22243,388,19737,457,15287,561,1037,240,18700,490,4450,455,2506,328
"2838","51033","Caroline County, Virginia",11000,389,10273,386,8309,440,391,152,9882,395,1964,330,727,170
"2839","51035","Carroll County, Virginia",12127,376,9924,445,7397,500,599,140,9325,450,2527,363,2203,316
"2840","51036","Charles City County, Virginia",2932,62,2428,107,1812,111,125,41,2303,103,616,80,504,90
"2841","51037","Charlotte County, Virginia",4606,196,3576,240,2666,261,321,109,3255,219,910,167,1030,214
"2842","51041","Chesterfield County, Virginia",131350,664,126598,855,113421,1244,4627,485,121971,911,13177,1122,4752,473
"2843","51043","Clarke County, Virginia",5692,194,5390,221,4633,260,429,142,4961,237,757,167,302,127
"2844","51045","Craig County, Virginia",1941,186,1836,188,1239,208,57,52,1779,190,597,201,105,50
"2845","51047","Culpeper County, Virginia",17692,396,16564,480,14397,590,619,185,15945,509,2167,392,1128,286
"2846","51049","Cumberland County, Virginia",3990,179,3452,215,2654,251,272,119,3180,214,798,212,538,152
"2847","51051","Dickenson County, Virginia",5573,230,4539,262,3362,294,455,177,4084,294,1177,170,1034,161
"2848","51053","Dinwiddie County, Virginia",10268,359,9201,415,7052,489,314,125,8887,428,2149,372,1067,220
"2849","51057","Essex County, Virginia",4299,158,3628,182,2649,217,152,67,3476,190,979,178,671,160
"2850","51059","Fairfax County, Virginia",408673,1255,399796,1432,378133,1621,10504,770,389292,1460,21663,1215,8877,733
"2851","51061","Fauquier County, Virginia",25472,432,24187,492,21281,601,954,155,23233,532,2906,459,1285,239
"2852","51063","Floyd County, Virginia",6695,219,5576,298,4481,322,438,154,5138,312,1095,256,1119,299
"2853","51065","Fluvanna County, Virginia",9979,258,9391,283,8406,307,408,155,8983,324,985,234,588,139
"2854","51067","Franklin County, Virginia",22033,518,19140,631,15901,668,1719,367,17421,574,3239,462,2893,451
"2855","51069","Frederick County, Virginia",32723,431,29794,574,25853,754,1363,269,28431,592,3941,519,2929,443
"2856","51071","Giles County, Virginia",6824,307,5803,318,4048,351,305,95,5498,320,1755,259,1021,193
"2857","51073","Gloucester County, Virginia",14882,383,13657,407,11618,487,724,194,12933,455,2039,415,1225,304
"2858","51075","Goochland County, Virginia",9454,271,8841,319,7804,324,208,92,8633,326,1037,231,613,181
"2859","51077","Grayson County, Virginia",6112,257,5143,255,3608,264,516,131,4627,258,1535,212,969,144
"2860","51079","Greene County, Virginia",7533,266,7126,265,6240,352,335,115,6791,279,886,259,407,169
"2861","51081","Greensville County, Virginia",3183,237,2763,236,2027,206,244,89,2519,250,736,190,420,104
"2862","51083","Halifax County, Virginia",13506,400,9769,541,7681,492,895,189,8874,548,2088,304,3737,431
"2863","51085","Hanover County, Virginia",40310,399,38212,584,34085,719,1542,237,36670,618,4127,508,2098,346
"2864","51087","Henrico County, Virginia",132465,1011,124620,1158,109432,1278,4817,519,119803,1300,15188,1077,7845,732
"2865","51089","Henry County, Virginia",20516,482,16797,512,12697,541,1199,196,15598,495,4100,445,3719,452
"2866","51091","Highland County, Virginia",987,87,809,87,659,76,99,39,710,89,150,59,178,85
"2867","51093","Isle of Wight County, Virginia",15063,337,13623,362,11592,405,557,129,13066,333,2031,316,1440,253
"2868","51095","James City County, Virginia",29748,479,28480,537,26159,589,1137,248,27343,599,2321,430,1268,224
"2869","51097","King and Queen County, Virginia",2803,132,2377,181,1736,174,67,44,2310,188,641,170,426,144
"2870","51099","King George County, Virginia",9445,211,9009,247,7955,330,299,105,8710,259,1054,254,436,157
"2871","51101","King William County, Virginia",6667,176,6157,195,5090,269,167,76,5990,195,1067,221,510,153
"2872","51103","Lancaster County, Virginia",5197,284,4159,324,3467,312,277,85,3882,330,692,152,1038,268
"2873","51105","Lee County, Virginia",8244,385,6724,374,4568,369,461,188,6263,374,2156,283,1520,240
"2874","51107","Loudoun County, Virginia",135690,464,133297,546,127760,721,2826,337,130471,666,5537,584,2393,306
"2875","51109","Louisa County, Virginia",14192,370,13155,414,10752,409,622,168,12533,402,2403,353,1037,194
"2876","51111","Lunenburg County, Virginia",4304,193,2868,255,2435,263,266,91,2602,236,433,119,1436,253
"2877","51113","Madison County, Virginia",5175,242,4747,267,3831,288,256,109,4491,265,916,190,428,146
"2878","51115","Mathews County, Virginia",3558,300,3144,307,2658,322,266,138,2878,319,486,222,414,200
"2879","51117","Mecklenburg County, Virginia",12655,407,9718,429,7809,395,820,178,8898,450,1909,242,2937,315
"2880","51119","Middlesex County, Virginia",4579,248,3928,300,3220,280,177,77,3751,299,708,199,651,199
"2881","51121","Montgomery County, Virginia",35533,746,33693,749,29045,864,1136,278,32557,815,4648,636,1840,343
"2882","51125","Nelson County, Virginia",6149,385,5472,368,4618,348,375,113,5097,369,854,209,677,161
"2883","51127","New Kent County, Virginia",8306,238,7799,311,7079,326,181,98,7618,331,720,243,507,222
"2884","51131","Northampton County, Virginia",5292,235,4698,287,3530,261,283,94,4415,283,1168,214,594,153
"2885","51133","Northumberland County, Virginia",5127,356,4421,359,3896,321,295,117,4126,372,525,179,706,169
"2886","51135","Nottoway County, Virginia",5309,287,4010,313,3287,302,283,105,3727,324,723,202,1299,289
"2887","51137","Orange County, Virginia",13970,386,12805,445,10630,648,547,140,12258,463,2175,505,1165,287
"2888","51139","Page County, Virginia",9355,291,7454,375,5860,421,695,187,6759,384,1594,268,1901,346
"2889","51141","Patrick County, Virginia",7732,360,6329,359,5013,337,565,157,5764,367,1316,229,1403,264
"2890","51143","Pittsylvania County, Virginia",24663,418,20775,549,15578,535,1621,264,19154,565,5197,549,3888,428
"2891","51145","Powhatan County, Virginia",10722,301,10349,339,9151,401,277,106,10072,344,1198,304,373,196
"2892","51147","Prince Edward County, Virginia",7113,410,5825,440,4938,441,528,160,5297,474,887,231,1288,233
"2893","51149","Prince George County, Virginia",12492,403,11782,420,10447,439,585,174,11197,456,1335,279,710,188
"2894","51153","Prince William County, Virginia",150488,771,147594,866,135753,1252,3512,440,144082,955,11841,955,2894,361
"2895","51155","Pulaski County, Virginia",14534,393,12634,481,9555,442,668,148,11966,460,3079,454,1900,309
"2896","51157","Rappahannock County, Virginia",2773,174,2669,185,2204,191,229,92,2440,206,465,162,104,59
"2897","51159","Richmond County, Virginia",2811,221,2271,253,1802,228,102,72,2169,254,469,159,540,131
"2898","51161","Roanoke County, Virginia",39087,419,35908,530,31009,779,1599,299,34309,549,4899,680,3179,396
"2899","51163","Rockbridge County, Virginia",9045,369,7987,370,6336,408,527,167,7460,375,1651,303,1058,240
"2900","51165","Rockingham County, Virginia",31189,414,27641,536,23031,684,1527,258,26114,562,4610,527,3548,402
"2901","51167","Russell County, Virginia",10355,311,8105,455,5640,476,383,125,7722,457,2465,451,2250,353
"2902","51169","Scott County, Virginia",8612,284,6798,307,5208,258,586,155,6212,307,1590,227,1814,225
"2903","51171","Shenandoah County, Virginia",17487,324,15315,421,12657,454,1096,217,14219,465,2658,355,2172,285
"2904","51173","Smyth County, Virginia",12607,318,10604,379,8236,429,792,189,9812,404,2368,308,2003,223
"2905","51175","Southampton County, Virginia",6661,270,5875,319,4700,295,177,83,5698,309,1175,219,786,177
"2906","51177","Spotsylvania County, Virginia",47944,489,46207,502,41938,617,1877,292,44330,545,4269,415,1737,280
"2907","51179","Stafford County, Virginia",49469,507,48554,539,44301,746,936,297,47618,644,4253,565,915,180
"2908","51181","Surry County, Virginia",2720,131,2285,177,1792,154,101,47,2184,179,493,118,435,128
"2909","51183","Sussex County, Virginia",3656,182,3068,210,2018,215,153,61,2915,208,1050,176,588,108
"2910","51185","Tazewell County, Virginia",15759,489,13635,471,9785,567,737,162,12898,467,3850,453,2124,305
"2911","51187","Warren County, Virginia",15082,319,13963,354,12025,544,556,152,13407,381,1938,406,1119,230
"2912","51191","Washington County, Virginia",21845,388,19105,515,15242,595,1102,202,18003,523,3863,423,2740,393
"2913","51193","Westmoreland County, Virginia",7873,371,6794,377,5366,391,516,193,6278,407,1428,314,1079,260
"2914","51195","Wise County, Virginia",14025,397,12087,441,8718,497,667,141,11420,468,3369,385,1938,333
"2915","51197","Wythe County, Virginia",12125,356,10451,399,7705,461,767,214,9684,373,2746,398,1674,263
"2916","51199","York County, Virginia",25389,376,24234,424,22657,436,865,183,23369,439,1577,248,1155,302
"2917","51510","Alexandria city, Virginia",74224,679,71748,717,64804,1047,1641,290,70107,758,6944,833,2476,452
"2918","51520","Bristol city, Virginia",7347,271,6268,341,4923,351,488,149,5780,361,1345,276,1079,247
"2919","51530","Buena Vista city, Virginia",2581,194,2164,228,1668,286,165,111,1999,251,496,193,417,171
"2920","51540","Charlottesville city, Virginia",19312,332,18356,390,16287,502,781,209,17575,412,2069,274,956,202
"2921","51550","Chesapeake city, Virginia",89413,621,86390,634,76506,1047,2608,341,83782,678,9884,849,3023,411
"2922","51570","Colonial Heights city, Virginia",7465,198,6908,241,5608,328,331,138,6577,265,1300,236,557,184
"2923","51580","Covington city, Virginia",2547,149,2250,172,1576,198,86,57,2164,184,674,175,297,94
"2924","51590","Danville city, Virginia",18590,385,15770,453,10745,517,858,176,14912,439,5025,497,2820,363
"2925","51595","Emporia city, Virginia",2240,217,1947,202,1118,204,157,97,1790,197,829,209,293,118
"2926","51600","Fairfax city, Virginia",9090,145,8957,145,8380,218,396,177,8561,237,577,161,133,67
"2927","51610","Falls Church city, Virginia",5630,159,5583,172,5501,185,229,123,5354,193,82,65,47,52
"2928","51620","Franklin city, Virginia",3474,190,3049,220,2130,211,294,132,2755,254,919,211,425,114
"2929","51630","Fredericksburg city, Virginia",11198,356,10594,420,8923,519,312,108,10282,431,1671,372,604,203
"2930","51640","Galax city, Virginia",2780,211,2454,210,1863,195,174,76,2280,203,591,160,326,104
"2931","51650","Hampton city, Virginia",57116,664,53538,815,45804,907,2154,339,51384,859,7734,713,3578,466
"2932","51660","Harrisonburg city, Virginia",17102,450,15926,488,13195,589,558,134,15368,498,2731,439,1176,226
"2933","51670","Hopewell city, Virginia",9269,303,8353,335,6244,436,263,91,8090,333,2109,366,916,211
"2934","51678","Lexington city, Virginia",2005,275,1882,271,1555,252,108,69,1774,261,327,169,123,71
"2935","51680","Lynchburg city, Virginia",28939,643,26984,680,22632,685,1141,229,25843,730,4352,585,1955,234
"2936","51683","Manassas city, Virginia",13562,258,13024,312,11711,377,300,110,12724,316,1313,235,538,164
"2937","51685","Manassas Park city, Virginia",5155,182,5016,183,4259,244,108,86,4908,202,757,247,139,78
"2938","51690","Martinsville city, Virginia",5656,243,4993,274,3674,297,311,107,4682,268,1319,225,663,179
"2939","51700","Newport News city, Virginia",74922,693,69801,880,57412,1159,2771,374,67030,908,12389,948,5121,516
"2940","51710","Norfolk city, Virginia",92877,1200,86816,1253,69941,1361,2587,283,84229,1294,16875,1031,6061,486
"2941","51720","Norton city, Virginia",1540,142,1370,147,1066,174,136,78,1234,138,304,139,170,109
"2942","51730","Petersburg city, Virginia",14464,343,12593,423,9183,496,577,167,12016,428,3410,394,1871,309
"2943","51735","Poquoson city, Virginia",4617,116,4350,146,4183,161,151,70,4199,153,167,66,267,100
"2944","51740","Portsmouth city, Virginia",38553,527,35593,627,27234,832,1821,253,33772,664,8359,724,2960,351
"2945","51750","Radford city, Virginia",5545,262,5098,288,4569,308,46,38,5052,289,529,165,447,155
"2946","51760","Richmond city, Virginia",98821,1000,90341,1250,74383,1388,2558,413,87783,1339,15958,993,8480,780
"2947","51770","Roanoke city, Virginia",42766,664,38004,823,28592,882,1662,278,36342,886,9412,741,4762,502
"2948","51775","Salem city, Virginia",9971,297,9131,339,7458,399,408,118,8723,339,1673,307,840,169
"2949","51790","Staunton city, Virginia",11125,283,9711,322,7783,404,497,147,9214,315,1928,335,1414,235
"2950","51800","Suffolk city, Virginia",35249,375,32808,465,28454,602,1139,244,31669,509,4354,471,2441,296
"2951","51810","Virginia Beach city, Virginia",177046,963,170726,1195,153750,1425,5211,628,165515,1249,16976,1116,6320,691
"2952","51820","Waynesboro city, Virginia",9419,310,8545,365,6841,370,464,137,8081,352,1704,311,874,204
"2953","51830","Williamsburg city, Virginia",4778,308,4646,299,4059,345,204,106,4442,299,587,190,132,74
"2954","51840","Winchester city, Virginia",11018,314,9854,427,8436,434,516,162,9338,411,1418,294,1164,316
"2955","53001","Adams County, Washington",6158,123,5477,217,3571,284,184,58,5293,213,1906,275,681,167
"2956","53003","Asotin County, Washington",9287,213,8779,256,7335,306,445,96,8334,254,1444,275,508,132
"2957","53005","Benton County, Washington",74290,653,70783,751,61555,994,2918,418,67865,729,9228,773,3507,472
"2958","53007","Chelan County, Washington",29474,535,27500,626,23100,761,1671,307,25829,661,4400,569,1974,362
"2959","53009","Clallam County, Washington",33636,514,31268,541,27186,615,2759,319,28509,546,4082,463,2368,371
"2960","53011","Clark County, Washington",184173,736,177533,872,159537,1262,7005,679,170528,1140,17996,985,6640,510
"2961","53013","Columbia County, Washington",1849,101,1738,107,1449,127,156,55,1582,112,289,85,111,47
"2962","53015","Cowlitz County, Washington",42776,470,39657,546,33333,815,2465,370,37192,573,6324,704,3119,369
"2963","53017","Douglas County, Washington",15278,248,14114,327,11843,358,694,165,13420,359,2271,326,1164,251
"2964","53019","Ferry County, Washington",2934,169,2525,192,1988,167,283,69,2242,195,537,136,409,79
"2965","53021","Franklin County, Washington",27721,315,26512,395,21582,681,826,225,25686,455,4930,607,1209,269
"2966","53023","Garfield County, Washington",1004,75,898,73,783,76,62,33,836,78,115,49,106,49
"2967","53025","Grant County, Washington",32803,521,30453,654,23772,836,1272,269,29181,689,6681,677,2350,399
"2968","53027","Grays Harbor County, Washington",29319,649,26822,749,21947,762,1748,246,25074,751,4875,476,2497,362
"2969","53029","Island County, Washington",35102,805,33743,815,31157,814,1527,233,32216,797,2586,411,1359,313
"2970","53031","Jefferson County, Washington",15497,432,14289,502,12589,467,1134,246,13155,525,1700,296,1208,328
"2971","53033","King County, Washington",902308,2293,874132,2733,804138,3884,24137,1265,849995,3086,69994,2542,28176,1513
"2972","53035","Kitsap County, Washington",104977,837,101577,946,93588,1048,4418,523,97159,1000,7989,582,3400,366
"2973","53037","Kittitas County, Washington",18772,489,18077,563,16371,660,717,171,17360,609,1706,324,695,173
"2974","53039","Klickitat County, Washington",9332,234,8688,287,7582,380,682,221,8006,346,1106,264,644,166
"2975","53041","Lewis County, Washington",31223,425,28805,506,24390,642,2225,306,26580,544,4415,444,2418,297
"2976","53043","Lincoln County, Washington",4440,121,4176,138,3538,138,416,94,3760,153,638,118,264,61
"2977","53045","Mason County, Washington",25085,556,23323,612,20570,650,1284,276,22039,629,2753,417,1762,290
"2978","53047","Okanogan County, Washington",16630,468,15225,471,12382,497,1257,214,13968,468,2843,423,1405,220
"2979","53049","Pacific County, Washington",9878,394,9023,424,7427,391,708,134,8315,412,1596,256,855,187
"2980","53051","Pend Oreille County, Washington",5653,271,5260,280,4419,306,370,104,4890,274,841,169,393,86
"2981","53053","Pierce County, Washington",335969,1254,322365,1729,285928,2321,11262,757,311103,1722,36437,1728,13604,889
"2982","53055","San Juan County, Washington",8378,193,8070,204,7489,210,407,63,7663,205,581,86,308,64
"2983","53057","Skagit County, Washington",50540,434,47860,546,42396,683,2369,289,45491,619,5464,525,2680,319
"2984","53059","Skamania County, Washington",4723,146,4253,185,3794,182,344,86,3909,207,459,119,470,129
"2985","53061","Snohomish County, Washington",302970,1069,292844,1238,266931,1517,10000,685,282844,1350,25913,1082,10126,715
"2986","53063","Spokane County, Washington",209640,1011,197760,1279,172110,1431,8294,638,189466,1391,25650,1279,11880,807
"2987","53065","Stevens County, Washington",18222,353,16411,351,13465,404,1351,195,15060,411,2946,326,1811,243
"2988","53067","Thurston County, Washington",114556,685,109517,963,99375,1476,4966,516,104551,992,10142,1016,5039,742
"2989","53069","Wahkiakum County, Washington",1891,123,1765,131,1537,139,174,62,1591,131,228,88,126,56
"2990","53071","Walla Walla County, Washington",22842,369,21535,422,18624,479,1001,218,20534,421,2911,397,1307,262
"2991","53073","Whatcom County, Washington",89865,705,85797,848,76879,1079,4232,600,81565,1025,8918,809,4068,543
"2992","53075","Whitman County, Washington",18010,627,17309,639,16044,637,782,141,16527,650,1265,195,701,166
"2993","53077","Yakima County, Washington",84636,576,77593,800,58520,1035,3171,382,74422,766,19073,997,7043,574
"2994","54001","Barbour County, West Virginia",5813,224,5069,268,3652,305,316,122,4753,271,1417,291,744,160
"2995","54003","Berkeley County, West Virginia",46838,477,43522,653,35831,1107,1783,313,41739,679,7691,899,3316,474
"2996","54005","Boone County, West Virginia",7821,263,6899,311,5321,297,646,169,6253,331,1578,242,922,168
"2997","54007","Braxton County, West Virginia",4532,266,3733,253,2794,210,509,175,3224,275,939,214,799,181
"2998","54009","Brooke County, West Virginia",9811,223,8606,345,6967,355,494,124,8112,353,1639,340,1205,303
"2999","54011","Cabell County, West Virginia",39398,649,34630,736,26402,833,1582,299,33048,784,8228,728,4768,550
"3000","54013","Calhoun County, West Virginia",2390,177,1992,175,1608,179,244,77,1748,190,384,121,398,87
"3001","54015","Clay County, West Virginia",2896,164,2320,202,1728,194,140,74,2180,188,592,144,576,111
"3002","54017","Doddridge County, West Virginia",2309,186,2029,181,1439,177,216,101,1813,188,590,126,280,82
"3003","54019","Fayette County, West Virginia",15836,335,13214,405,10037,508,782,176,12432,425,3177,372,2622,271
"3004","54021","Gilmer County, West Virginia",2127,179,1684,175,1394,167,177,57,1507,180,290,97,443,89
"3005","54023","Grant County, West Virginia",4147,205,3339,238,2396,237,242,73,3097,246,943,235,808,164
"3006","54025","Greenbrier County, West Virginia",14722,454,12186,531,9380,529,803,211,11383,543,2806,369,2536,354
"3007","54027","Hampshire County, West Virginia",7912,406,6659,432,5471,362,1190,305,5469,456,1188,276,1253,268
"3008","54029","Hancock County, West Virginia",12840,282,11418,358,8802,474,665,180,10753,358,2616,400,1422,252
"3009","54031","Hardy County, West Virginia",5794,276,5088,319,4160,334,793,186,4295,335,928,228,706,228
"3010","54033","Harrison County, West Virginia",26129,456,23322,571,18512,603,1080,229,22242,599,4810,522,2807,398
"3011","54035","Jackson County, West Virginia",11127,306,9107,426,7051,562,495,207,8612,446,2056,390,2020,372
"3012","54037","Jefferson County, West Virginia",21162,323,19727,410,17195,464,775,194,18952,437,2532,321,1435,275
"3013","54039","Kanawha County, West Virginia",76919,955,68862,1227,52773,1323,3616,470,65246,1253,16089,907,8057,752
"3014","54041","Lewis County, West Virginia",6662,262,5467,243,4114,274,352,116,5115,251,1353,231,1195,200
"3015","54043","Lincoln County, West Virginia",7759,319,6646,414,5490,422,644,277,6002,437,1156,224,1113,222
"3016","54045","Logan County, West Virginia",12382,380,10789,465,8172,528,712,208,10077,433,2617,401,1593,314
"3017","54047","McDowell County, West Virginia",6413,292,5239,331,3649,319,617,191,4622,359,1590,286,1174,182
"3018","54049","Marion County, West Virginia",23278,417,20945,446,16475,537,1278,206,19667,426,4470,424,2333,323
"3019","54051","Marshall County, West Virginia",11811,376,9976,459,8132,428,821,198,9155,502,1844,379,1835,313
"3020","54053","Mason County, West Virginia",10057,348,8345,365,6591,418,743,208,7602,369,1754,290,1712,255
"3021","54055","Mercer County, West Virginia",24634,507,21232,652,15660,740,1515,290,19717,657,5572,534,3402,443
"3022","54057","Mineral County, West Virginia",10431,379,9362,421,7657,397,512,139,8850,465,1705,335,1069,270
"3023","54059","Mingo County, West Virginia",9110,252,7616,311,5043,355,693,176,6923,346,2573,333,1494,238
"3024","54061","Monongalia County, West Virginia",43640,622,41092,702,36786,760,1627,261,39465,719,4306,490,2548,408
"3025","54063","Monroe County, West Virginia",4493,202,3729,254,2722,270,458,140,3271,262,1007,216,764,184
"3026","54065","Morgan County, West Virginia",6957,274,6236,329,5057,363,677,247,5559,382,1179,229,721,192
"3027","54067","Nicholas County, West Virginia",9678,294,8467,374,6035,464,716,206,7751,389,2432,415,1211,305
"3028","54069","Ohio County, West Virginia",17447,392,15053,427,12231,413,1144,226,13909,423,2822,362,2394,319
"3029","54071","Pendleton County, West Virginia",2333,136,1702,163,1394,148,250,77,1452,163,308,96,631,103
"3030","54073","Pleasants County, West Virginia",2688,194,2407,191,2015,191,161,63,2246,190,392,104,281,75
"3031","54075","Pocahontas County, West Virginia",2912,189,2122,200,1732,196,335,118,1787,180,390,87,790,179
"3032","54077","Preston County, West Virginia",12510,371,10945,421,8597,427,1000,207,9945,439,2348,315,1565,227
"3033","54079","Putnam County, West Virginia",22075,410,20029,535,16021,641,826,219,19203,562,4008,496,2046,300
"3034","54081","Raleigh County, West Virginia",30033,567,25509,655,19299,761,1615,291,23894,658,6210,679,4524,589
"3035","54083","Randolph County, West Virginia",10065,355,8185,433,6083,448,774,172,7411,450,2102,277,1880,251
"3036","54085","Ritchie County, West Virginia",3121,178,2684,187,2156,179,250,69,2434,189,528,132,437,101
"3037","54087","Roane County, West Virginia",5376,245,4409,286,3124,237,415,130,3994,283,1285,227,967,165
"3038","54089","Summers County, West Virginia",4982,235,3838,320,2640,326,221,101,3617,304,1198,227,1144,260
"3039","54091","Taylor County, West Virginia",6557,231,5703,295,4261,334,285,137,5418,316,1442,248,854,220
"3040","54093","Tucker County, West Virginia",2790,172,2348,148,1911,130,161,51,2187,152,437,99,442,81
"3041","54095","Tyler County, West Virginia",2894,139,2441,147,2090,148,419,87,2022,153,351,84,453,102
"3042","54097","Upshur County, West Virginia",9599,291,8419,366,6234,436,548,194,7871,390,2185,325,1180,250
"3043","54099","Wayne County, West Virginia",14479,440,12167,538,9902,585,982,236,11185,504,2265,332,2312,453
"3044","54101","Webster County, West Virginia",2964,190,2494,170,1762,186,257,77,2237,183,732,140,470,135
"3045","54103","Wetzel County, West Virginia",5603,245,4608,232,3612,260,637,177,3971,245,996,191,995,163
"3046","54105","Wirt County, West Virginia",2081,138,1749,150,1431,160,166,71,1583,145,318,105,332,106
"3047","54107","Wood County, West Virginia",35220,515,31373,633,24764,615,2444,348,28929,714,6609,596,3847,453
"3048","54109","Wyoming County, West Virginia",7795,301,6191,344,4267,348,481,163,5710,338,1924,317,1604,254
"3049","55001","Adams County, Wisconsin",8783,292,7602,279,6192,239,655,100,6947,283,1410,156,1181,148
"3050","55003","Ashland County, Wisconsin",6624,208,5721,213,4770,222,489,81,5232,225,951,137,903,151
"3051","55005","Barron County, Wisconsin",18969,351,17107,389,13759,401,1245,176,15862,364,3348,302,1862,214
"3052","55007","Bayfield County, Wisconsin",7358,172,6717,194,5807,184,555,77,6162,183,910,113,641,87
"3053","55009","Brown County, Wisconsin",107772,666,99969,836,85986,1129,4459,570,95510,920,13983,932,7803,656
"3054","55011","Buffalo County, Wisconsin",5550,138,4881,158,3965,152,442,62,4439,153,916,121,669,104
"3055","55013","Burnett County, Wisconsin",6990,182,6292,185,4897,164,507,73,5785,195,1395,107,698,84
"3056","55015","Calumet County, Wisconsin",20467,218,19213,267,17029,371,1015,223,18198,324,2184,265,1254,204
"3057","55017","Chippewa County, Wisconsin",26056,330,23700,371,19611,538,1256,205,22444,412,4089,431,2356,262
"3058","55019","Clark County, Wisconsin",12591,196,10275,195,8324,195,884,90,9391,197,1951,142,2316,158
"3059","55021","Columbia County, Wisconsin",24016,288,21806,331,18893,421,1532,246,20274,395,2913,352,2210,243
"3060","55023","Crawford County, Wisconsin",6508,207,5619,219,4738,209,574,102,5045,218,881,128,889,124
"3061","55025","Dane County, Wisconsin",236036,890,226709,1204,208308,1644,9119,776,217590,1327,18401,1095,9327,759
"3062","55027","Dodge County, Wisconsin",35291,391,32040,487,27054,588,2043,282,29997,468,4986,387,3251,367
"3063","55029","Door County, Wisconsin",13612,367,12754,387,10825,365,830,148,11924,415,1929,263,858,166
"3064","55031","Douglas County, Wisconsin",18865,309,17342,311,14237,378,1274,190,16068,368,3105,312,1523,193
"3065","55033","Dunn County, Wisconsin",17277,293,15941,321,13806,366,955,175,14986,323,2135,217,1336,183
"3066","55035","Eau Claire County, Wisconsin",41976,393,38766,607,33826,730,2014,278,36752,619,4940,446,3210,495
"3067","55037","Florence County, Wisconsin",2076,104,1900,107,1502,97,128,40,1772,111,398,74,176,79
"3068","55039","Fond du Lac County, Wisconsin",42151,547,38122,652,32701,785,2055,294,36067,679,5421,498,4029,433
"3069","55041","Forest County, Wisconsin",3660,133,3206,133,2559,154,200,30,3006,127,647,87,454,53
"3070","55043","Grant County, Wisconsin",19775,298,17688,328,15220,372,1255,163,16433,352,2468,254,2087,182
"3071","55045","Green County, Wisconsin",15392,181,13869,233,11633,299,818,143,13051,261,2236,258,1523,219
"3072","55047","Green Lake County, Wisconsin",7987,186,7145,193,5889,218,566,103,6579,196,1256,170,842,101
"3073","55049","Iowa County, Wisconsin",9749,181,8765,199,7481,230,516,103,8249,232,1284,151,984,161
"3074","55051","Iron County, Wisconsin",2801,128,2531,126,2079,122,218,45,2313,141,452,64,270,55
"3075","55053","Jackson County, Wisconsin",7950,153,6933,200,5513,223,547,108,6386,233,1420,192,1017,141
"3076","55055","Jefferson County, Wisconsin",33861,373,31244,471,27147,614,1958,318,29286,539,4097,359,2617,329
"3077","55057","Juneau County, Wisconsin",10363,271,9348,285,7383,270,568,83,8780,264,1965,181,1015,119
"3078","55059","Kenosha County, Wisconsin",65877,608,61605,721,52598,801,2619,341,58986,782,9007,659,4272,443
"3079","55061","Kewaunee County, Wisconsin",8104,214,7190,249,6084,258,388,84,6802,249,1106,145,914,156
"3080","55063","La Crosse County, Wisconsin",49603,457,45617,553,39592,810,2190,229,43427,566,6025,578,3986,488
"3081","55065","Lafayette County, Wisconsin",6667,98,5723,124,4643,127,413,81,5310,127,1080,109,944,101
"3082","55067","Langlade County, Wisconsin",8404,301,7230,329,5969,339,535,147,6695,312,1261,194,1174,212
"3083","55069","Lincoln County, Wisconsin",12055,238,10857,264,8804,326,794,138,10063,266,2053,243,1198,168
"3084","55071","Manitowoc County, Wisconsin",34834,494,31002,574,26103,588,1951,267,29051,562,4899,418,3832,401
"3085","55073","Marathon County, Wisconsin",56218,425,51600,560,44575,717,3019,315,48581,593,7025,585,4618,364
"3086","55075","Marinette County, Wisconsin",18344,368,16162,404,13313,434,1173,186,14989,431,2849,317,2182,212
"3087","55077","Marquette County, Wisconsin",6688,126,5887,154,4815,166,609,123,5278,149,1072,100,801,99
"3088","55078","Menominee County, Wisconsin",1251,124,1086,128,773,137,55,31,1031,133,313,73,165,66
"3089","55079","Milwaukee County, Wisconsin",387392,1683,349477,2339,281872,2808,15986,989,333491,2469,67605,1808,37915,1574
"3090","55081","Monroe County, Wisconsin",17733,278,15508,342,13109,446,1033,183,14475,349,2399,293,2225,273
"3091","55083","Oconto County, Wisconsin",16352,220,14880,239,12168,280,864,115,14016,245,2712,235,1472,157
"3092","55085","Oneida County, Wisconsin",15724,407,14298,433,12424,423,979,150,13319,425,1874,203,1426,237
"3093","55087","Outagamie County, Wisconsin",75847,481,70982,672,61817,804,3059,330,67923,704,9165,602,4865,452
"3094","55089","Ozaukee County, Wisconsin",36889,696,34966,726,31987,845,2042,330,32924,726,2979,459,1923,287
"3095","55091","Pepin County, Wisconsin",3058,83,2706,95,2248,90,143,42,2563,107,458,81,352,52
"3096","55093","Pierce County, Wisconsin",15860,214,14772,261,12713,360,771,141,14001,310,2059,282,1088,165
"3097","55095","Polk County, Wisconsin",18263,276,16676,302,13809,291,991,110,15685,331,2867,218,1587,177
"3098","55097","Portage County, Wisconsin",29041,290,26959,347,23432,482,1448,226,25511,373,3527,322,2082,235
"3099","55099","Price County, Wisconsin",6576,174,5744,169,4752,190,727,79,5017,165,992,130,832,99
"3100","55101","Racine County, Wisconsin",79040,589,73739,799,62259,967,4077,452,69662,828,11480,810,5301,501
"3101","55103","Richland County, Wisconsin",7157,169,6025,195,4963,216,668,106,5357,195,1062,137,1132,116
"3102","55105","Rock County, Wisconsin",66030,461,61154,667,50862,982,3137,438,58017,722,10292,788,4876,468
"3103","55107","Rusk County, Wisconsin",6063,157,5205,163,4181,171,495,80,4710,183,1024,110,858,98
"3104","55109","St. Croix County, Wisconsin",35387,354,33601,486,29497,567,1255,200,32346,508,4104,546,1786,367
"3105","55111","Sauk County, Wisconsin",26850,354,24308,408,20880,484,1535,207,22773,417,3428,328,2542,330
"3106","55113","Sawyer County, Wisconsin",7932,239,6854,238,5727,264,558,100,6296,227,1127,179,1078,150
"3107","55115","Shawano County, Wisconsin",16732,274,14459,326,11576,324,1133,147,13326,353,2883,272,2273,175
"3108","55117","Sheboygan County, Wisconsin",48751,416,44883,518,38659,703,2547,327,42336,622,6224,569,3868,319
"3109","55119","Taylor County, Wisconsin",7691,182,6510,205,5314,233,655,100,5855,210,1196,139,1181,147
"3110","55121","Trempealeau County, Wisconsin",12201,122,10844,179,8645,258,628,86,10216,194,2199,214,1357,141
"3111","55123","Vernon County, Wisconsin",11833,159,9911,182,8450,189,942,132,8969,217,1461,171,1922,168
"3112","55125","Vilas County, Wisconsin",10550,365,9546,391,7947,363,688,98,8858,384,1599,186,1004,149
"3113","55127","Walworth County, Wisconsin",42018,527,39319,562,34273,729,1933,315,37386,572,5046,541,2699,325
"3114","55129","Washburn County, Wisconsin",7084,191,6359,183,5144,177,504,76,5855,185,1215,135,725,99
"3115","55131","Washington County, Wisconsin",55807,425,52321,642,46930,779,2586,393,49735,681,5391,573,3486,431
"3116","55133","Waukesha County, Wisconsin",164141,744,156004,980,143949,1063,7522,620,148482,1120,12055,830,8137,663
"3117","55135","Waupaca County, Wisconsin",22173,331,19868,404,16553,507,1204,181,18664,391,3315,347,2305,239
"3118","55137","Waushara County, Wisconsin",9886,177,8639,210,6986,220,573,84,8066,226,1653,182,1247,112
"3119","55139","Winnebago County, Wisconsin",71416,621,66596,703,57196,940,3613,411,62983,717,9400,693,4820,384
"3120","55141","Wood County, Wisconsin",31790,432,28681,446,23689,589,2139,288,26542,501,4992,479,3109,330
"3121","56001","Albany County, Wyoming",16016,358,15432,379,14363,407,490,164,14942,421,1069,222,584,156
"3122","56003","Big Horn County, Wyoming",4215,165,3824,168,3281,166,262,74,3562,176,543,110,391,123
"3123","56005","Campbell County, Wyoming",17190,460,16556,474,14081,589,385,151,16171,483,2475,437,634,231
"3124","56007","Carbon County, Wyoming",5937,286,5419,298,4288,279,224,72,5195,317,1131,243,518,131
"3125","56009","Converse County, Wyoming",5636,243,5322,252,4568,299,163,93,5159,252,754,187,314,114
"3126","56011","Crook County, Wyoming",2822,160,2637,180,2246,205,182,57,2455,174,391,122,185,68
"3127","56013","Fremont County, Wyoming",14490,273,13114,296,10537,333,919,188,12195,321,2577,271,1376,165
"3128","56015","Goshen County, Wyoming",4962,204,4424,221,3578,241,293,81,4131,221,846,169,538,131
"3129","56017","Hot Springs County, Wyoming",2085,157,1940,163,1526,138,90,45,1850,159,414,135,145,71
"3130","56019","Johnson County, Wyoming",3825,176,3515,234,2838,256,281,116,3234,225,677,192,310,160
"3131","56021","Laramie County, Wyoming",40842,428,38632,517,33877,657,1652,335,36980,578,4755,546,2210,320
"3132","56023","Lincoln County, Wyoming",7383,246,7134,255,6115,303,391,121,6743,279,1019,231,249,91
"3133","56025","Natrona County, Wyoming",32634,557,30781,620,25988,644,1410,253,29371,677,4793,541,1853,301
"3134","56027","Niobrara County, Wyoming",1017,102,922,94,814,105,85,43,837,96,108,53,95,48
"3135","56029","Park County, Wyoming",12607,416,11990,447,10511,545,1331,344,10659,459,1479,343,617,204
"3136","56031","Platte County, Wyoming",3793,205,3194,271,2612,249,298,127,2896,286,582,162,599,159
"3137","56033","Sheridan County, Wyoming",13003,362,11548,431,10054,427,783,213,10765,445,1494,284,1455,300
"3138","56035","Sublette County, Wyoming",3337,253,3235,261,2701,259,45,46,3190,258,534,229,102,62
"3139","56037","Sweetwater County, Wyoming",15529,394,14796,447,12450,479,289,86,14507,429,2346,292,733,181
"3140","56039","Teton County, Wyoming",9531,433,9344,437,8641,514,307,127,9037,453,703,286,187,100
"3141","56041","Uinta County, Wyoming",7675,315,7232,357,6126,393,318,134,6914,376,1106,256,443,134
"3142","56043","Washakie County, Wyoming",3370,166,3095,177,2507,182,125,63,2970,185,588,134,275,108
"3143","56045","Weston County, Wyoming",2754,172,2506,170,2098,176,207,82,2299,188,408,131,248,88
"3144","72001","Adjuntas Municipio, Puerto Rico",5611,257,4071,270,1965,259,67,38,4004,281,2106,276,1540,212
"3145","72003","Aguada Municipio, Puerto Rico",12995,459,7241,542,5313,539,557,163,6684,533,1928,311,5754,367
"3146","72005","Aguadilla Municipio, Puerto Rico",21442,532,16664,539,9727,522,660,177,16004,556,6937,532,4778,497
"3147","72007","Aguas Buenas Municipio, Puerto Rico",8917,303,7286,378,3450,334,181,141,7105,399,3836,350,1631,269
"3148","72009","Aibonito Municipio, Puerto Rico",8764,228,4444,343,3295,314,660,175,3784,336,1149,196,4320,309
"3149","72011","Añasco Municipio, Puerto Rico",8883,361,5768,373,4143,347,570,184,5198,359,1625,242,3115,292
"3150","72013","Arecibo Municipio, Puerto Rico",31624,630,23332,787,13800,796,649,162,22683,761,9532,665,8292,513
"3151","72015","Arroyo Municipio, Puerto Rico",6147,315,3795,391,2450,362,296,143,3499,380,1345,325,2352,303
"3152","72017","Barceloneta Municipio, Puerto Rico",7847,338,6112,426,3232,420,119,81,5993,417,2880,450,1735,318
"3153","72019","Barranquitas Municipio, Puerto Rico",8863,364,6824,391,3074,328,181,122,6643,384,3750,366,2039,272
"3154","72021","Bayamón Municipio, Puerto Rico",66689,853,58039,901,34565,800,2202,226,55837,899,23474,861,8650,482
"3155","72023","Cabo Rojo Municipio, Puerto Rico",16722,586,9642,611,5949,580,204,90,9438,617,3693,471,7080,565
"3156","72025","Caguas Municipio, Puerto Rico",48226,623,39415,758,25004,743,1295,226,38120,766,14411,777,8811,585
"3157","72027","Camuy Municipio, Puerto Rico",11367,369,8402,426,4839,416,316,117,8086,454,3563,360,2965,336
"3158","72029","Canóvanas Municipio, Puerto Rico",14612,429,12656,459,6731,513,239,85,12417,454,5925,519,1956,311
"3159","72031","Carolina Municipio, Puerto Rico",61112,914,52993,1072,32990,982,1560,228,51433,1093,20003,925,8119,670
"3160","72033","Cataño Municipio, Puerto Rico",8716,261,7361,302,3429,303,145,66,7216,301,3932,322,1355,180
"3161","72035","Cayey Municipio, Puerto Rico",16022,477,12856,508,6997,432,253,102,12603,501,5859,479,3166,373
"3162","72037","Ceiba Municipio, Puerto Rico",4123,263,3155,267,1942,228,86,62,3069,265,1213,195,968,163
"3163","72039","Ciales Municipio, Puerto Rico",5623,206,4299,270,1877,291,104,66,4195,270,2422,290,1324,172
"3164","72041","Cidra Municipio, Puerto Rico",13447,285,10290,380,5454,448,135,60,10155,385,4836,435,3157,334
"3165","72043","Coamo Municipio, Puerto Rico",13023,385,7065,454,5556,432,719,208,6346,455,1509,245,5958,391
"3166","72045","Comerío Municipio, Puerto Rico",5274,269,3225,321,1214,265,93,51,3132,329,2011,275,2049,269
"3167","72047","Corozal Municipio, Puerto Rico",10614,384,7887,416,3905,417,65,44,7822,423,3982,477,2727,366
"3168","72049","Culebra Municipio, Puerto Rico",489,75,399,65,230,55,10,15,389,65,169,44,90,37
"3169","72051","Dorado Municipio, Puerto Rico",11807,358,10640,478,6261,543,217,90,10423,485,4379,422,1167,267
"3170","72053","Fajardo Municipio, Puerto Rico",12158,454,9919,500,5359,411,258,77,9661,497,4560,426,2239,295
"3171","72054","Florida Municipio, Puerto Rico",4331,242,3360,291,1764,314,37,44,3323,300,1596,277,971,221
"3172","72055","Guánica Municipio, Puerto Rico",5518,279,3425,315,2437,292,142,79,3283,318,988,196,2093,244
"3173","72057","Guayama Municipio, Puerto Rico",14127,541,9028,614,5931,545,1044,263,7984,590,3097,373,5099,506
"3174","72059","Guayanilla Municipio, Puerto Rico",6375,285,4891,291,2690,288,134,59,4757,296,2201,288,1484,198
"3175","72061","Guaynabo Municipio, Puerto Rico",31429,636,27301,697,19491,730,773,172,26528,711,7810,596,4128,402
"3176","72063","Gurabo Municipio, Puerto Rico",14486,554,12134,593,7881,636,290,144,11844,582,4253,548,2352,335
"3177","72065","Hatillo Municipio, Puerto Rico",13634,443,10341,469,6195,466,194,85,10147,465,4146,480,3293,397
"3178","72067","Hormigueros Municipio, Puerto Rico",6272,283,5067,290,2933,284,183,84,4884,282,2134,303,1205,195
"3179","72069","Humacao Municipio, Puerto Rico",17749,544,13455,604,7419,527,171,60,13284,612,6036,491,4294,442
"3180","72071","Isabela Municipio, Puerto Rico",14846,530,8614,525,6076,463,1061,287,7553,485,2538,357,6232,507
"3181","72073","Jayuya Municipio, Puerto Rico",5004,271,3855,351,1844,308,72,68,3783,332,2011,329,1149,223
"3182","72075","Juana Díaz Municipio, Puerto Rico",15287,462,12043,540,7091,519,350,130,11693,553,4952,444,3244,328
"3183","72077","Juncos Municipio, Puerto Rico",13065,439,11004,473,5001,487,79,62,10925,468,6003,568,2061,301
"3184","72079","Lajas Municipio, Puerto Rico",7765,379,4291,412,2487,344,348,144,3943,390,1804,340,3474,360
"3185","72081","Lares Municipio, Puerto Rico",9882,333,6948,395,4163,349,336,125,6612,392,2785,338,2934,282
"3186","72083","Las Marías Municipio, Puerto Rico",2695,205,1196,211,942,201,595,179,601,142,254,81,1499,197
"3187","72085","Las Piedras Municipio, Puerto Rico",12068,449,9904,509,5488,461,99,86,9805,487,4416,411,2164,337
"3188","72087","Loíza Municipio, Puerto Rico",8727,286,7117,340,3003,302,139,69,6978,345,4114,299,1610,234
"3189","72089","Luquillo Municipio, Puerto Rico",6803,322,5506,335,2623,281,145,75,5361,346,2883,307,1297,189
"3190","72091","Manatí Municipio, Puerto Rico",14500,460,11733,523,5914,477,363,123,11370,509,5819,458,2767,345
"3191","72093","Maricao Municipio, Puerto Rico",1888,150,814,164,682,156,341,116,473,122,132,57,1074,160
"3192","72095","Maunabo Municipio, Puerto Rico",3891,254,3071,286,1274,225,36,42,3035,280,1797,243,820,190
"3193","72097","Mayagüez Municipio, Puerto Rico",29241,606,23531,691,13396,634,931,229,22600,718,10135,647,5710,389
"3194","72099","Moca Municipio, Puerto Rico",13315,384,10070,512,5436,431,276,118,9794,525,4634,504,3245,383
"3195","72101","Morovis Municipio, Puerto Rico",9654,326,8083,335,4085,374,127,77,7956,344,3998,376,1571,244
"3196","72103","Naguabo Municipio, Puerto Rico",8160,469,6629,486,3250,461,139,112,6490,488,3379,488,1531,330
"3197","72105","Naranjito Municipio, Puerto Rico",8302,416,5347,484,2412,365,73,57,5274,489,2935,465,2955,340
"3198","72107","Orocovis Municipio, Puerto Rico",6828,238,4582,302,2377,222,109,59,4473,304,2205,244,2246,249
"3199","72109","Patillas Municipio, Puerto Rico",5869,308,4379,362,1944,302,34,56,4345,364,2435,368,1490,206
"3200","72111","Peñuelas Municipio, Puerto Rico",6756,324,5298,351,2925,276,84,44,5214,351,2373,327,1458,226
"3201","72113","Ponce Municipio, Puerto Rico",52008,791,37797,926,24699,843,2816,310,34981,919,13098,702,14211,660
"3202","72115","Quebradillas Municipio, Puerto Rico",8261,412,6460,476,3434,422,67,66,6393,474,3026,441,1801,306
"3203","72117","Rincón Municipio, Puerto Rico",5704,316,3883,367,2715,304,283,108,3600,370,1168,240,1821,312
"3204","72119","Río Grande Municipio, Puerto Rico",15573,544,13048,585,6474,528,234,96,12814,599,6574,550,2525,321
"3205","72121","Sabana Grande Municipio, Puerto Rico",6868,342,4694,311,3242,274,247,108,4447,332,1452,233,2174,266
"3206","72123","Salinas Municipio, Puerto Rico",9778,385,5245,479,3911,435,605,165,4640,467,1334,248,4533,405
"3207","72125","San Germán Municipio, Puerto Rico",11475,422,5055,388,4167,390,2080,277,2975,326,888,159,6420,397
"3208","72127","San Juan Municipio, Puerto Rico",142829,1192,100997,1585,67225,1428,7856,619,93141,1678,33772,1214,41832,1353
"3209","72129","San Lorenzo Municipio, Puerto Rico",13571,421,9751,453,5074,515,297,138,9454,450,4677,452,3820,407
"3210","72131","San Sebastián Municipio, Puerto Rico",13808,425,8933,511,5218,465,542,186,8391,532,3715,404,4875,478
"3211","72133","Santa Isabel Municipio, Puerto Rico",7258,288,4276,356,3435,352,543,179,3733,349,841,211,2982,315
"3212","72135","Toa Alta Municipio, Puerto Rico",22055,494,19419,512,11304,691,389,148,19030,513,8115,609,2636,325
"3213","72137","Toa Baja Municipio, Puerto Rico",28002,530,24262,593,13745,674,464,116,23798,592,10517,616,3740,388
"3214","72139","Trujillo Alto Municipio, Puerto Rico",24022,556,20881,647,13924,680,563,150,20318,627,6957,557,3141,367
"3215","72141","Utuado Municipio, Puerto Rico",10111,335,7056,354,3755,318,274,115,6782,369,3301,372,3055,278
"3216","72143","Vega Alta Municipio, Puerto Rico",12146,549,9513,547,4961,463,120,77,9393,538,4552,477,2633,343
"3217","72145","Vega Baja Municipio, Puerto Rico",19799,451,15581,493,8219,586,329,108,15252,502,7362,592,4218,395
"3218","72147","Vieques Municipio, Puerto Rico",2374,293,1821,315,829,229,38,47,1783,317,992,261,553,176
"3219","72149","Villalba Municipio, Puerto Rico",7823,313,6138,370,2923,297,118,57,6020,373,3215,310,1685,248
"3220","72151","Yabucoa Municipio, Puerto Rico",11905,390,8520,429,3965,452,110,60,8410,431,4555,445,3385,354
"3221","72153","Yauco Municipio, Puerto Rico",11836,379,8103,417,5259,402,172,78,7931,433,2844,319,3733,351
