"","GEOID","NAME","B28010_001E","B28010_001M","B28010_002E","B28010_002M","B28010_003E","B28010_003M","B28010_004E","B28010_004M","B28010_005E","B28010_005M","B28010_006E","B28010_006M","B28010_007E","B28010_007M"
"1","01003","Baldwin County, Alabama",83501,2931,77443,2976,62729,3103,4403,1110,73040,3060,14714,2142,6058,1474
"2","01015","Calhoun County, Alabama",44264,1834,38768,1871,30768,1971,3054,879,35714,2156,8000,1295,5496,969
"3","01043","Cullman County, Alabama",30323,1437,26269,1408,19117,1648,654,324,25615,1423,7152,1392,4054,753
"4","01049","DeKalb County, Alabama",26462,1458,22675,1395,15879,1478,1440,692,21235,1510,6796,1222,3787,904
"5","01051","Elmore County, Alabama",30155,1094,26120,1194,21528,1274,599,356,25521,1263,4592,1262,4035,874
"6","01055","Etowah County, Alabama",38625,1544,34041,1772,23824,1641,1682,569,32359,1869,10217,1604,4584,888
"7","01069","Houston County, Alabama",38861,1098,31815,1167,24932,1068,3843,589,27972,1123,6883,798,7046,800
"8","01073","Jefferson County, Alabama",255940,3851,228104,4302,182830,4522,7648,1218,220456,4381,45274,3698,27836,2209
"9","01077","Lauderdale County, Alabama",38670,1735,33173,2072,26145,2001,2465,823,30708,2025,7028,1275,5497,1147
"10","01081","Lee County, Alabama",59336,1847,54953,2202,46742,2701,1720,697,53233,2264,8211,1801,4383,1349
"11","01083","Limestone County, Alabama",32333,1294,29448,1423,24010,1615,997,399,28451,1504,5438,1099,2885,730
"12","01089","Madison County, Alabama",152723,1873,142330,2671,123026,3935,5721,1052,136609,2921,19304,2809,10393,1677
"13","01095","Marshall County, Alabama",36022,1112,31983,1408,23158,1900,1282,430,30701,1397,8825,1422,4039,947
"14","01097","Mobile County, Alabama",158627,3164,139806,3179,98921,3209,5796,1130,134010,3247,40885,3084,18821,1979
"15","01101","Montgomery County, Alabama",87553,2304,77480,2684,57320,2757,2629,688,74851,2494,20160,1964,10073,1512
"16","01103","Morgan County, Alabama",45851,1482,39562,1910,33452,2013,2728,954,36834,1858,6110,1115,6289,1457
"17","01115","St. Clair County, Alabama",30765,1596,27064,1950,22292,1965,2325,1050,24739,2132,4772,1256,3701,1149
"18","01117","Shelby County, Alabama",80944,1588,77041,1777,65403,2147,1715,578,75326,1803,11638,1569,3903,1037
"19","01121","Talladega County, Alabama",31219,1460,26614,1675,20191,1735,1601,548,25013,1660,6423,1302,4605,1156
"20","01125","Tuscaloosa County, Alabama",74053,2334,66782,2497,51504,2580,2904,1020,63878,2566,15278,2200,7271,1232
"21","01127","Walker County, Alabama",24870,1142,20611,1177,14556,1446,1057,410,19554,1232,6055,1087,4259,935
"22","02020","Anchorage Municipality, Alaska",105285,2132,102774,2178,88842,3010,2062,579,100712,2176,13932,2155,2511,773
"23","02090","Fairbanks North Star Borough, Alaska",36378,1770,35386,1718,30985,2041,1717,743,33669,1781,4401,1474,992,550
"24","02170","Matanuska-Susitna Borough, Alaska",32198,833,30574,945,26787,1061,1551,394,29023,929,3787,622,1624,393
"25","04001","Apache County, Arizona",21936,1023,11613,911,8410,982,962,379,10651,866,3203,799,10323,906
"26","04003","Cochise County, Arizona",49751,1727,44638,1930,39402,2044,2766,733,41872,1907,5236,1133,5113,1191
"27","04005","Coconino County, Arizona",47275,2211,44044,2198,37624,2245,2278,776,41766,2251,6420,1284,3231,896
"28","04013","Maricopa County, Arizona",1582464,7714,1500214,8034,1307207,8650,57746,3141,1442468,8275,193007,7063,82250,3977
"29","04015","Mohave County, Arizona",90270,2972,80602,3259,67373,3596,7901,1532,72701,3527,13229,1935,9668,2071
"30","04017","Navajo County, Arizona",34285,1984,27048,1800,20566,1640,1474,442,25574,1823,6482,1045,7237,935
"31","04019","Pima County, Arizona",402323,4369,376840,4770,316529,5464,16702,1909,360138,4651,60311,4044,25483,2482
"32","04021","Pinal County, Arizona",147936,3458,138369,3397,121272,3395,6354,1429,132015,3562,17097,2063,9567,1604
"33","04025","Yavapai County, Arizona",100836,2498,92633,2994,77780,3212,6783,1063,85850,3105,14853,2478,8203,1627
"34","04027","Yuma County, Arizona",74532,2212,66552,2529,53466,2475,3024,816,63528,2464,13086,1884,7980,1388
"35","05007","Benton County, Arkansas",100128,1660,94182,2024,81112,2338,3187,787,90995,2163,13070,1891,5946,1252
"36","05031","Craighead County, Arkansas",42631,1302,39087,1695,30722,1949,2333,1194,36754,1857,8365,1449,3544,917
"37","05045","Faulkner County, Arkansas",43701,1747,39629,1925,34115,1946,1701,554,37928,1863,5514,1142,4072,1099
"38","05051","Garland County, Arkansas",40407,1643,37110,1509,27877,1806,1737,555,35373,1627,9233,1660,3297,898
"39","05069","Jefferson County, Arkansas",25689,1314,22166,1708,13304,1471,663,333,21503,1672,8862,1432,3523,819
"40","05085","Lonoke County, Arkansas",28132,566,25624,862,19720,1402,796,321,24828,952,5904,1182,2508,720
"41","05119","Pulaski County, Arkansas",157678,2932,143655,3506,112748,4174,4907,1152,138748,3594,30907,2887,14023,1720
"42","05125","Saline County, Arkansas",43496,1418,40809,1562,32942,1722,1374,512,39435,1555,7867,1357,2687,816
"43","05131","Sebastian County, Arkansas",51739,1476,47160,1826,33589,1921,1477,491,45683,1881,13571,1717,4579,1093
"44","05143","Washington County, Arkansas",90001,1627,84136,1991,70653,2420,2985,747,81151,2162,13483,2060,5865,1326
"45","05145","White County, Arkansas",29577,1291,25602,1347,19561,1522,2050,785,23552,1464,6041,1277,3975,1000
"46","06001","Alameda County, California",575410,4162,549040,4882,504098,5376,16100,1700,532940,4393,44942,3153,26370,2676
"47","06007","Butte County, California",88636,1728,83087,2174,71638,2581,5251,1057,77836,2131,11449,1937,5549,1242
"48","06013","Contra Costa County, California",396133,3132,380012,3615,342255,4066,11527,1706,368485,3501,37757,2950,16121,2294
"49","06017","El Dorado County, California",72774,1878,69132,2010,63043,2065,3829,841,65303,2098,6089,1473,3642,1039
"50","06019","Fresno County, California",309519,2529,279866,3700,216263,4049,9222,1269,270644,4055,63603,3463,29653,2673
"51","06023","Humboldt County, California",55773,1388,52300,1489,42756,2194,3454,844,48846,1824,9544,1798,3473,847
"52","06025","Imperial County, California",41764,2195,38640,2374,28583,2270,1357,613,37283,2366,10057,1718,3124,860
"53","06029","Kern County, California",273167,3833,251273,4467,194748,5399,8279,1223,242994,4809,56525,4536,21894,2614
"54","06031","Kings County, California",43727,1039,40173,1364,31968,1880,1160,509,39013,1322,8205,1418,3554,951
"55","06033","Lake County, California",26774,1463,24036,1575,19321,1697,1718,649,22318,1561,4715,1210,2738,894
"56","06037","Los Angeles County, California",3313908,10529,3094720,11438,2659755,14031,99419,4764,2995301,11977,434965,9586,219188,6358
"57","06039","Madera County, California",44484,1786,40738,1880,31689,2046,2165,752,38573,1907,9049,1454,3746,940
"58","06041","Marin County, California",104954,1838,101622,2106,96467,2353,4662,1124,96960,2134,5155,1103,3332,1135
"59","06045","Mendocino County, California",33794,1416,30311,1714,25288,1864,2502,761,27809,1518,5023,1020,3483,1017
"60","06047","Merced County, California",79487,1497,73109,1926,54396,2801,2531,731,70578,2048,18713,2388,6378,1231
"61","06053","Monterey County, California",126299,2071,118675,2523,92757,2794,4293,972,114382,2749,25918,2592,7624,1496
"62","06055","Napa County, California",47315,1405,44730,1525,40103,1747,2256,758,42474,1754,4627,988,2585,767
"63","06057","Nevada County, California",41447,1915,38969,2115,35502,2187,2623,650,36346,2039,3467,1219,2478,822
"64","06059","Orange County, California",1040394,5391,1000857,5496,909008,7233,28913,2193,971944,5947,91849,5688,39537,3465
"65","06061","Placer County, California",144691,2698,138946,2881,130081,3005,5815,1049,133131,2892,8865,1439,5745,1074
"66","06065","Riverside County, California",728103,4596,687688,5503,587572,6617,27005,2238,660683,5913,100116,4397,40415,3272
"67","06067","Sacramento County, California",543560,3122,518300,3773,458995,5196,17987,1974,500313,4116,59305,4065,25260,2238
"68","06071","San Bernardino County, California",638647,5380,604937,5723,497069,6545,19851,2120,585086,5912,107868,5449,33710,3179
"69","06073","San Diego County, California",1130911,6394,1086855,7773,973980,9277,32473,2651,1054382,7175,112875,5297,44056,3704
"70","06075","San Francisco County, California",362827,5010,340536,5653,311468,5774,9572,2160,330964,5838,29068,2555,22291,2539
"71","06077","San Joaquin County, California",231917,1766,217678,2170,171939,3801,6445,1092,211233,2385,45739,3342,14239,1432
"72","06079","San Luis Obispo County, California",106198,2386,99874,2805,88815,3195,4543,910,95331,2857,11059,2230,6324,1368
"73","06081","San Mateo County, California",259654,3087,250464,3173,232961,3581,7274,1318,243190,3491,17503,2286,9190,1758
"74","06083","Santa Barbara County, California",146224,2369,138374,2599,121189,2900,5732,1089,132642,2750,17185,1886,7850,1498
"75","06085","Santa Clara County, California",645108,4162,623546,4365,579756,5413,16692,1705,606854,4618,43790,3765,21562,2596
"76","06087","Santa Cruz County, California",94994,2034,89378,2298,81041,2678,4059,1023,85319,2383,8337,1876,5616,1214
"77","06089","Shasta County, California",68198,1621,63143,1792,51914,2079,3822,800,59321,1728,11229,1768,5055,979
"78","06095","Solano County, California",152291,1537,145529,1910,127734,2720,5073,1078,140456,2080,17795,2253,6762,1221
"79","06097","Sonoma County, California",187434,2355,179720,2792,160906,3293,10106,1445,169614,2904,18814,2089,7714,1413
"80","06099","Stanislaus County, California",175171,1600,162869,2168,129143,3314,6099,1170,156770,2264,33726,3036,12302,1710
"81","06101","Sutter County, California",31989,879,29191,1146,24057,1386,1019,343,28172,1137,5134,1023,2798,856
"82","06107","Tulare County, California",139197,1618,122672,2183,84751,3242,4040,1131,118632,2442,37921,3264,16525,1638
"83","06111","Ventura County, California",271980,2680,254813,3565,226920,4144,10441,1278,244372,3537,27893,2943,17167,2215
"84","06113","Yolo County, California",74428,1333,70734,1488,62928,2081,3129,898,67605,1650,7806,1678,3694,1050
"85","06115","Yuba County, California",26191,1076,22746,1320,18045,1492,1157,508,21589,1317,4701,1025,3445,932
"86","08001","Adams County, Colorado",168361,1559,158905,2120,133894,3070,6979,1184,151926,2424,25011,2620,9456,1545
"87","08005","Arapahoe County, Colorado",242141,2134,232126,2587,206476,3246,8609,1297,223517,2736,25650,2602,10015,1625
"88","08013","Boulder County, Colorado",128295,1837,123421,2123,115072,2489,5359,917,118062,2397,8349,1578,4874,1032
"89","08014","Broomfield County, Colorado",28530,450,27966,579,26071,931,331,221,27635,593,1895,801,564,291
"90","08031","Denver County, Colorado",310324,3035,294918,3578,262698,4120,9412,1420,285506,3874,32220,3205,15406,1991
"91","08035","Douglas County, Colorado",125035,1382,122857,1636,118472,1623,2568,828,120289,1704,4385,945,2178,732
"92","08041","El Paso County, Colorado",260851,2707,247781,3036,223251,3920,9006,1390,238775,3557,24530,2823,13070,1748
"93","08059","Jefferson County, Colorado",233272,1980,219964,2614,200737,3127,9050,1386,210914,3019,19227,2303,13308,1887
"94","08069","Larimer County, Colorado",139382,2415,133801,2729,123300,2630,4207,1113,129594,2950,10501,1825,5581,1305
"95","08077","Mesa County, Colorado",61848,1549,56995,1690,48177,2004,3380,806,53615,1716,8818,1840,4853,1057
"96","08101","Pueblo County, Colorado",64954,1271,57916,1777,45062,2089,3797,632,54119,1750,12854,1751,7038,1089
"97","08123","Weld County, Colorado",107929,1530,102751,1819,89105,2224,3713,877,99038,1841,13646,2041,5178,1179
"98","09001","Fairfield County, Connecticut",345634,3285,325221,3418,288112,4481,12419,1604,312802,3701,37109,3198,20413,2001
"99","09003","Hartford County, Connecticut",348049,3171,320183,3420,271553,4667,14596,1840,305587,3634,48630,3735,27866,2593
"100","09005","Litchfield County, Connecticut",73598,1684,67520,1990,59851,2064,5055,1024,62465,2227,7669,1295,6078,1189
"101","09007","Middlesex County, Connecticut",66983,1949,62516,1970,55933,2163,3337,851,59179,1980,6583,1141,4467,1012
"102","09009","New Haven County, Connecticut",335539,3432,303843,4222,255655,5177,15330,1805,288513,4008,48188,4578,31696,3305
"103","09011","New London County, Connecticut",108098,1938,100040,2399,87133,2769,6654,1193,93386,2514,12907,1676,8058,1547
"104","09013","Tolland County, Connecticut",55619,1737,52027,1779,47593,2129,2906,631,49121,1816,4434,1279,3592,832
"105","09015","Windham County, Connecticut",44571,1494,40500,1888,34171,1879,1932,620,38568,1877,6329,1424,4071,1002
"106","10001","Kent County, Delaware",67841,1367,60595,1868,49129,2281,3022,824,57573,1906,11466,1785,7246,1256
"107","10003","New Castle County, Delaware",206351,2324,196008,2807,154555,4074,8261,1208,187747,3098,41453,3722,10343,1444
"108","10005","Sussex County, Delaware",93479,3097,84814,3378,71736,3316,5935,1232,78879,3293,13078,1917,8665,1566
"109","11001","District of Columbia, District of Columbia",287476,2752,266613,3420,230574,4069,6223,1303,260390,3401,36039,3155,20863,2403
"110","12001","Alachua County, Florida",97782,2912,93407,2896,84307,2960,2718,690,90689,2931,9100,1530,4375,1189
"111","12005","Bay County, Florida",73856,2382,68037,2511,59104,2717,3584,888,64453,2547,8933,1796,5819,1311
"112","12009","Brevard County, Florida",226363,4269,209537,4646,191261,4728,13728,1889,195809,4961,18276,2114,16826,2650
"113","12011","Broward County, Florida",694980,6477,655599,6862,568484,8084,22383,2579,633216,6875,87115,4404,39381,3214
"114","12015","Charlotte County, Florida",74975,3063,67947,3061,59858,2834,4480,1041,63467,2910,8089,1511,7028,1251
"115","12017","Citrus County, Florida",62293,2908,57105,3166,48393,3075,7108,1496,49997,3205,8712,2015,5188,1260
"116","12019","Clay County, Florida",75958,2151,73268,2310,64658,2822,3448,1152,69820,2381,8610,2082,2690,961
"117","12021","Collier County, Florida",144172,4574,134294,4843,116323,4580,7996,1503,126298,4934,17971,2568,9878,1902
"118","12023","Columbia County, Florida",25678,967,24000,979,18876,1491,1435,598,22565,1082,5124,1163,1678,607
"119","12031","Duval County, Florida",367238,4633,342926,5253,282083,5431,14725,2044,328201,5670,60843,4929,24312,2664
"120","12033","Escambia County, Florida",118820,3150,109334,3508,95368,3222,5983,1204,103351,3693,13966,2148,9486,1704
"121","12035","Flagler County, Florida",41274,1947,36375,2220,31301,1943,3168,911,33207,2257,5074,1188,4899,1429
"122","12053","Hernando County, Florida",76163,2250,71041,2517,64337,2704,6479,1167,64562,2738,6704,1397,5122,1069
"123","12055","Highlands County, Florida",40573,2282,34959,2197,28685,2229,2830,784,32129,2131,6274,1291,5614,1348
"124","12057","Hillsborough County, Florida",540142,4045,514288,5159,436693,6084,16229,1951,498059,5337,77595,4408,25854,3050
"125","12061","Indian River County, Florida",57636,2600,51246,2684,46644,2579,4057,1063,47189,2794,4602,1322,6390,1348
"126","12069","Lake County, Florida",136366,3542,127494,3874,109000,3947,7544,1240,119950,4120,18494,2762,8872,1731
"127","12071","Lee County, Florida",281222,6698,264914,7343,226378,6295,12747,1962,252167,7150,38536,3541,16308,2628
"128","12073","Leon County, Florida",113390,2646,106790,2618,94209,3087,3796,959,102994,2831,12581,1903,6600,1147
"129","12081","Manatee County, Florida",150814,3654,142268,3501,124945,4111,8387,1362,133881,3538,17323,2276,8546,1735
"130","12083","Marion County, Florida",143441,4064,127543,4417,108861,4796,11464,1642,116079,4346,18682,2702,15898,2551
"131","12085","Martin County, Florida",63070,2157,59088,2354,50430,2222,3590,922,55498,2450,8658,1485,3982,1130
"132","12086","Miami-Dade County, Florida",895801,6705,837519,7091,689232,8065,21322,2043,816197,6952,148287,6439,58282,4156
"133","12087","Monroe County, Florida",31362,1892,30369,1844,26697,1971,1740,698,28629,1760,3672,810,993,439
"134","12089","Nassau County, Florida",32624,1353,31315,1489,27190,1832,1724,780,29591,1548,4125,1315,1309,541
"135","12091","Okaloosa County, Florida",79570,2256,75461,2423,65572,2732,3321,1017,72140,2734,9889,1701,4109,1116
"136","12095","Orange County, Florida",458157,4549,436659,5346,379406,6846,10121,1493,426538,5416,57253,4433,21498,2811
"137","12097","Osceola County, Florida",102705,3890,97741,4135,82652,4212,2982,899,94759,4343,15089,2934,4964,1393
"138","12099","Palm Beach County, Florida",552286,5680,522553,5545,447478,5992,22680,1998,499873,6025,75075,4166,29733,2765
"139","12101","Pasco County, Florida",205128,3653,186401,4228,169346,4439,10844,1401,175557,4162,17055,1827,18727,2172
"140","12103","Pinellas County, Florida",405892,5053,370430,5400,326329,5778,24301,2288,346129,5558,44101,3029,35462,2907
"141","12105","Polk County, Florida",241171,4086,216983,4339,173662,5006,11841,1703,205142,4538,43321,3703,24188,2721
"142","12107","Putnam County, Florida",27927,1726,24878,1749,18444,1820,1222,449,23656,1801,6434,1283,3049,813
"143","12109","St. Johns County, Florida",90109,3058,85629,3241,79144,3444,4106,1154,81523,3468,6485,1491,4480,1246
"144","12111","St. Lucie County, Florida",118768,3239,113599,3442,97208,3893,4815,1281,108784,3529,16391,2701,5169,1252
"145","12113","Santa Rosa County, Florida",63891,2129,60536,2312,52899,2574,2448,750,58088,2429,7637,1693,3355,899
"146","12115","Sarasota County, Florida",183721,3804,171380,3993,150011,4521,11577,1893,159803,4213,21369,2402,12341,1919
"147","12117","Seminole County, Florida",179274,2475,171687,2911,156048,3544,7086,1394,164601,2949,15639,2562,7587,1645
"148","12119","Sumter County, Florida",62854,2590,58614,2673,54504,2693,5942,1627,52672,3028,4110,907,4240,1216
"149","12127","Volusia County, Florida",218423,4087,204073,4126,170798,3824,13454,1650,190619,4502,33275,2581,14350,1946
"150","12131","Walton County, Florida",28770,2180,26716,2245,23395,1952,1033,410,25683,2186,3321,1066,2054,767
"151","13013","Barrow County, Georgia",27525,714,25654,955,22430,1086,1021,437,24633,991,3224,804,1871,616
"152","13015","Bartow County, Georgia",35506,1553,33497,1652,27565,2171,1222,580,32275,1610,5932,1473,2009,816
"153","13021","Bibb County, Georgia",57905,1802,50225,2113,37039,2057,2139,652,48086,2202,13186,1614,7680,1353
"154","13031","Bulloch County, Georgia",27097,1613,24349,1773,19477,1933,810,376,23539,1755,4872,1171,2748,890
"155","13045","Carroll County, Georgia",41197,1480,36367,1566,28656,1898,1002,520,35365,1637,7711,1483,4830,1124
"156","13047","Catoosa County, Georgia",24722,1260,22000,1551,18696,1774,1717,727,20283,1555,3304,1005,2722,837
"157","13051","Chatham County, Georgia",107921,2645,101090,3048,82629,3274,2295,652,98795,3126,18461,2580,6831,1258
"158","13057","Cherokee County, Georgia",89974,1560,87696,1626,80919,2088,2278,808,85418,1930,6777,1578,2278,883
"159","13059","Clarke County, Georgia",49698,1441,46141,1743,41883,1823,1836,656,44305,1940,4258,1013,3557,971
"160","13063","Clayton County, Georgia",96286,2093,89596,2444,70753,3115,3286,947,86310,2641,18843,2483,6690,1576
"161","13067","Cobb County, Georgia",283094,3547,276380,4034,253738,4024,6756,1408,269624,3940,22642,2758,6714,1217
"162","13073","Columbia County, Georgia",47167,2238,44082,2167,38566,2171,1175,582,42907,2223,5516,1391,3085,1197
"163","13077","Coweta County, Georgia",52114,1333,48157,2040,40891,2431,1597,611,46560,2072,7266,1813,3957,1341
"164","13089","DeKalb County, Georgia",287001,3281,269348,3626,223811,4842,7924,1573,261424,3944,45537,4468,17653,2068
"165","13095","Dougherty County, Georgia",33717,1752,29913,1954,21272,1903,2154,705,27759,1907,8641,1537,3804,958
"166","13097","Douglas County, Georgia",49534,1582,48036,1711,38553,2285,995,477,47041,1777,9483,1921,1498,702
"167","13113","Fayette County, Georgia",39366,1116,36968,1255,34503,1356,964,477,36004,1354,2465,859,2398,796
"168","13115","Floyd County, Georgia",34672,1416,29331,1841,21903,1577,963,452,28368,1902,7428,1627,5341,1149
"169","13117","Forsyth County, Georgia",81353,873,79380,1061,74840,1474,1932,619,77448,1124,4540,907,1973,619
"170","13121","Fulton County, Georgia",417157,5974,392237,6705,349282,6289,10202,1879,382035,7048,42955,3864,24920,2681
"171","13127","Glynn County, Georgia",34634,1563,31445,1564,25797,1915,1902,778,29543,1721,5648,1676,3189,902
"172","13135","Gwinnett County, Georgia",297658,2747,285143,3607,256189,3893,6464,1434,278679,3808,28954,2721,12515,2269
"173","13139","Hall County, Georgia",64990,1594,60554,1995,49825,2205,2467,656,58087,2134,10729,1731,4436,1304
"174","13151","Henry County, Georgia",75926,1908,73627,1998,68049,2205,2766,838,70861,2028,5578,1470,2299,886
"175","13153","Houston County, Georgia",58155,1653,54954,1911,46171,2698,1448,660,53506,1886,8783,1893,3201,1266
"176","13157","Jackson County, Georgia",23640,877,22022,1147,19220,1113,452,293,21570,1186,2802,816,1618,738
"177","13185","Lowndes County, Georgia",41734,1535,32910,1886,27237,1850,1599,790,31311,2092,5673,1285,8824,1643
"178","13215","Muscogee County, Georgia",72862,2063,65456,2129,50913,2606,2237,655,63219,2077,14543,1836,7406,1148
"179","13217","Newton County, Georgia",38436,794,37405,907,33077,1356,1093,494,36312,985,4328,1027,1031,412
"180","13223","Paulding County, Georgia",53630,1664,51104,1777,45237,2239,899,563,50205,1924,5867,1590,2526,952
"181","13245","Richmond County, Georgia",70534,2579,62122,2724,45925,3103,2544,641,59578,2765,16197,2336,8412,1659
"182","13247","Rockdale County, Georgia",31460,985,30252,1247,25220,1726,752,363,29500,1259,5032,1209,1208,583
"183","13255","Spalding County, Georgia",25659,1135,22671,1344,17625,1528,968,533,21703,1428,5046,1175,2988,968
"184","13285","Troup County, Georgia",25417,1114,22573,1325,15758,1456,1279,632,21294,1407,6815,1381,2844,777
"185","13295","Walker County, Georgia",26895,1290,23224,1733,18915,1768,1267,471,21957,1776,4309,851,3671,1196
"186","13297","Walton County, Georgia",32624,792,29843,1415,25057,1577,1074,463,28769,1527,4786,1076,2781,1224
"187","13313","Whitfield County, Georgia",36658,1376,31640,1596,24093,1454,1691,776,29949,1803,7547,1492,5018,1176
"188","15001","Hawaii County, Hawaii",71565,2191,61539,2370,50087,2575,5046,1230,56493,2353,11452,1869,10026,1694
"189","15003","Honolulu County, Hawaii",308208,3354,286338,3798,249837,4327,9036,1318,277302,3969,36501,2690,21870,2050
"190","15007","Kauai County, Hawaii",22685,1210,20378,1195,17744,1370,1033,460,19345,1223,2634,799,2307,589
"191","15009","Maui County, Hawaii",52794,1950,48777,2028,41433,2285,1509,537,47268,2155,7344,1295,4017,1106
"192","16001","Ada County, Idaho",178712,2497,172131,2728,160425,3304,6932,1530,165199,2942,11706,1926,6581,1394
"193","16005","Bannock County, Idaho",30635,1217,28781,1275,24317,1384,1300,530,27481,1319,4464,1032,1854,549
"194","16019","Bonneville County, Idaho",40224,1153,38175,1182,32633,1434,1384,578,36791,1404,5542,1195,2049,632
"195","16027","Canyon County, Idaho",74520,1350,70667,1719,59782,2229,3656,1305,67011,2105,10885,1957,3853,828
"196","16055","Kootenai County, Idaho",64955,1328,59065,1833,50074,2241,2897,901,56168,1721,8991,1779,5890,1234
"197","16083","Twin Falls County, Idaho",32041,930,29162,1364,24127,1482,756,434,28406,1443,5035,1169,2879,1038
"198","17001","Adams County, Illinois",26397,972,23013,1123,19217,1259,1349,559,21664,1116,3796,872,3384,837
"199","17019","Champaign County, Illinois",84290,2237,78733,2535,68871,2943,3231,857,75502,2588,9862,1770,5557,1217
"200","17031","Cook County, Illinois",1981796,8626,1807902,10582,1525026,9984,63845,3888,1744057,10926,282876,9080,173894,6462
"201","17037","DeKalb County, Illinois",38849,1227,37110,1331,32817,1423,1041,440,36069,1500,4293,999,1739,499
"202","17043","DuPage County, Illinois",345714,2259,328790,2679,299943,3761,10789,1286,318001,2768,28847,2799,16924,1899
"203","17089","Kane County, Illinois",183633,1334,172564,1988,149458,2911,6927,1413,165637,2334,23106,2652,11069,1532
"204","17091","Kankakee County, Illinois",40642,1411,36080,1470,29621,1410,2203,640,33877,1499,6459,1177,4562,927
"205","17093","Kendall County, Illinois",40716,1134,39158,1295,36472,1595,974,635,38184,1395,2686,956,1558,839
"206","17097","Lake County, Illinois",246620,2599,234195,2959,209691,3680,10185,1376,224010,3200,24504,2563,12425,1559
"207","17099","LaSalle County, Illinois",44714,1263,40209,1452,31234,1788,1820,525,38389,1481,8975,1452,4505,927
"208","17111","McHenry County, Illinois",114544,1268,109953,1460,97825,2053,4474,1043,105479,1563,12128,1985,4591,936
"209","17113","McLean County, Illinois",65998,1534,62986,1642,56430,1772,1884,486,61102,1766,6556,1143,3012,802
"210","17115","Macon County, Illinois",44562,1294,39157,1516,31124,1560,2545,713,36612,1589,8033,1150,5405,943
"211","17119","Madison County, Illinois",108977,2233,99224,2515,84137,2646,6470,1414,92754,2771,15087,2214,9753,1629
"212","17143","Peoria County, Illinois",71506,1717,64925,2017,51696,2209,2156,630,62769,2176,13229,1997,6581,1156
"213","17161","Rock Island County, Illinois",61009,1278,55189,1550,44953,1914,2332,612,52857,1575,10236,1358,5820,1173
"214","17163","St. Clair County, Illinois",104803,2310,95493,2868,76493,3427,5503,1210,89990,2727,19000,2437,9310,1630
"215","17167","Sangamon County, Illinois",83006,1728,76429,1996,61907,2131,3417,784,73012,2118,14522,1888,6577,1037
"216","17179","Tazewell County, Illinois",54123,1441,48285,1937,38882,1893,2300,579,45985,1931,9403,1534,5838,1230
"217","17183","Vermilion County, Illinois",30166,1113,24786,1381,19819,1335,1693,496,23093,1359,4967,891,5380,892
"218","17197","Will County, Illinois",231647,2201,220388,2673,195847,3034,8008,1167,212380,2913,24541,2029,11259,1619
"219","17199","Williamson County, Illinois",27815,1041,22809,1672,15370,1573,944,428,21865,1658,7439,1145,5006,1309
"220","17201","Winnebago County, Illinois",114337,1684,104242,1967,83321,2530,5832,982,98410,2083,20921,2290,10095,1317
"221","18003","Allen County, Indiana",147638,1587,135591,2027,112854,2959,6674,1039,128917,2016,22737,2097,12047,1572
"222","18005","Bartholomew County, Indiana",31891,1053,27993,1442,23669,1454,699,375,27294,1439,4324,971,3898,1055
"223","18011","Boone County, Indiana",24808,1211,23528,1333,22173,1327,911,438,22617,1265,1355,672,1280,470
"224","18019","Clark County, Indiana",45905,1254,42569,1413,35077,1662,2049,726,40520,1629,7492,1165,3336,779
"225","18035","Delaware County, Indiana",45311,1941,40470,2135,34638,2246,2103,582,38367,2143,5832,1058,4841,950
"226","18039","Elkhart County, Indiana",73660,1927,66826,2173,53499,2434,2969,756,63857,2295,13327,1938,6834,1294
"227","18043","Floyd County, Indiana",30300,992,28457,1110,23851,1280,1382,471,27075,1121,4606,1087,1843,448
"228","18053","Grant County, Indiana",26923,973,23694,1196,18466,1345,1746,571,21948,1276,5228,1140,3229,867
"229","18057","Hamilton County, Indiana",122876,1759,119943,1809,112872,2257,1648,618,118295,1931,7071,1471,2933,803
"230","18059","Hancock County, Indiana",29605,726,27986,950,23774,1550,1251,571,26735,1055,4212,1333,1619,647
"231","18063","Hendricks County, Indiana",60368,1368,58917,1345,53151,1597,1828,611,57089,1490,5766,1121,1451,545
"232","18067","Howard County, Indiana",35139,1401,32794,1493,27267,1639,1995,627,30799,1494,5527,1235,2345,706
"233","18081","Johnson County, Indiana",57504,1377,54724,1579,47899,2194,2078,824,52646,1448,6825,1521,2780,838
"234","18085","Kosciusko County, Indiana",30798,1441,28537,1444,23308,1451,1715,646,26822,1455,5229,1044,2261,556
"235","18089","Lake County, Indiana",186769,2797,165964,3412,131048,3367,9123,1202,156841,3259,34916,2780,20805,2565
"236","18091","LaPorte County, Indiana",43122,1279,39774,1427,31576,1745,2683,735,37091,1315,8198,1355,3348,702
"237","18095","Madison County, Indiana",50426,1409,44764,1620,34817,1723,2256,587,42508,1761,9947,1473,5662,1024
"238","18097","Marion County, Indiana",373634,3704,332773,4632,269755,5324,15174,2136,317599,4640,63018,4213,40861,3746
"239","18105","Monroe County, Indiana",57102,1586,53973,1620,48841,1919,1800,612,52173,1739,5132,1245,3129,754
"240","18109","Morgan County, Indiana",25968,910,23482,1230,19334,1384,1275,492,22207,1214,4148,1041,2486,840
"241","18127","Porter County, Indiana",66144,1137,60782,1452,52843,2167,2895,791,57887,1501,7939,1687,5362,1149
"242","18141","St. Joseph County, Indiana",107730,1563,97565,1994,80442,2743,5280,1200,92285,2225,17123,1868,10165,1337
"243","18157","Tippecanoe County, Indiana",70446,1881,67482,2105,55108,2608,2581,592,64901,2226,12374,1854,2964,730
"244","18163","Vanderburgh County, Indiana",75058,2145,67730,2229,53018,2588,3035,740,64695,2317,14712,1916,7328,1100
"245","18167","Vigo County, Indiana",43262,1224,41034,1305,32699,1800,2792,740,38242,1221,8335,1461,2228,589
"246","18177","Wayne County, Indiana",28338,1083,25039,1239,19429,1358,1989,624,23050,1079,5610,1124,3299,737
"247","19013","Black Hawk County, Iowa",53386,1370,48181,1631,40238,1963,2242,598,45939,1822,7943,1289,5205,1063
"248","19049","Dallas County, Iowa",35492,987,34166,1212,30357,1382,821,488,33345,1219,3809,862,1326,619
"249","19061","Dubuque County, Iowa",38501,857,34154,1239,26962,1524,1901,579,32253,1208,7192,1036,4347,997
"250","19103","Johnson County, Iowa",60868,1735,58899,1799,53504,2037,1280,451,57619,1838,5395,1530,1969,558
"251","19113","Linn County, Iowa",91747,1599,84734,2277,74052,2503,2941,697,81793,2493,10682,1764,7013,1584
"252","19153","Polk County, Iowa",189546,2460,177807,2691,150489,3620,6632,1761,171175,3024,27318,2691,11739,1834
"253","19155","Pottawattamie County, Iowa",36635,1191,32694,1442,27407,1518,2459,497,30235,1443,5287,1081,3941,939
"254","19163","Scott County, Iowa",66905,1553,60918,1741,51279,1912,2207,741,58711,1837,9639,1153,5987,1318
"255","19169","Story County, Iowa",37290,1491,35715,1558,31810,1956,1438,432,34277,1574,3905,1274,1575,623
"256","19193","Woodbury County, Iowa",39253,1082,35283,1324,27993,1639,1944,644,33339,1322,7290,1252,3970,848
"257","20015","Butler County, Kansas",24692,1097,22459,1292,20112,1242,1179,451,21280,1374,2347,630,2233,762
"258","20045","Douglas County, Kansas",48907,1134,46947,1296,41475,1590,1786,724,45161,1374,5472,1425,1960,739
"259","20091","Johnson County, Kansas",231184,2411,222865,2673,205545,3351,7325,1279,215540,2788,17320,2379,8319,1295
"260","20103","Leavenworth County, Kansas",26654,1178,24444,1281,20173,1532,1045,405,23399,1227,4271,1053,2210,558
"261","20161","Riley County, Kansas",26617,1379,25963,1428,23439,1563,992,534,24971,1463,2524,776,654,316
"262","20173","Sedgwick County, Kansas",198024,2622,184013,2896,149608,3799,7337,1102,176676,3191,34405,3063,14011,1513
"263","20177","Shawnee County, Kansas",72788,1776,64970,2034,52897,2122,3101,720,61869,1980,12073,1701,7818,1440
"264","20209","Wyandotte County, Kansas",60708,1357,55301,1514,38679,1801,2797,660,52504,1528,16622,1592,5407,1021
"265","21015","Boone County, Kentucky",47684,1188,46036,1366,40431,1843,1880,641,44156,1431,5605,1514,1648,593
"266","21029","Bullitt County, Kentucky",29789,1053,27680,1185,23035,1312,1700,636,25980,1219,4645,990,2109,726
"267","21037","Campbell County, Kentucky",36992,1272,33549,1336,29083,1475,1399,433,32150,1370,4466,892,3443,660
"268","21047","Christian County, Kentucky",26114,1284,23151,1462,17570,1597,709,383,22442,1527,5581,1417,2963,738
"269","21059","Daviess County, Kentucky",39590,1165,35482,1543,27577,1815,1628,560,33854,1651,7905,1475,4108,1058
"270","21067","Fayette County, Kentucky",131067,2335,125508,2624,105794,3243,4184,939,121324,2786,19714,2483,5559,1080
"271","21093","Hardin County, Kentucky",41625,1438,37683,1900,29190,1819,1986,683,35697,1826,8493,1630,3942,1086
"272","21111","Jefferson County, Kentucky",311263,3624,281390,4658,231253,5341,12267,1621,269123,4802,50137,3888,29873,2990
"273","21117","Kenton County, Kentucky",64611,1348,60015,1430,51792,1756,2350,601,57665,1551,8223,1361,4596,797
"274","21145","McCracken County, Kentucky",27650,1360,25320,1397,20543,1579,1091,522,24229,1498,4777,1159,2330,588
"275","21151","Madison County, Kentucky",33396,1260,30450,1448,26530,1487,1423,546,29027,1413,3920,913,2946,787
"276","21185","Oldham County, Kentucky",21237,722,20492,848,18294,965,461,234,20031,879,2198,733,745,342
"277","21227","Warren County, Kentucky",48843,1450,45523,1760,38203,1823,2215,899,43308,1820,7320,1418,3320,1143
"278","22005","Ascension Parish, Louisiana",45102,1416,41978,1794,33616,2264,1169,537,40809,1817,8362,1969,3124,1098
"279","22015","Bossier Parish, Louisiana",50099,1937,45158,2058,36303,2140,1495,539,43663,2018,8855,1632,4941,1493
"280","22017","Caddo Parish, Louisiana",94778,2026,82577,2272,58598,2661,4163,871,78414,2354,23979,2491,12201,1759
"281","22019","Calcasieu Parish, Louisiana",78351,2393,68280,2545,53035,2845,2382,726,65898,2594,15245,2089,10071,1461
"282","22033","East Baton Rouge Parish, Louisiana",163274,3664,149950,3947,120500,4305,4349,1233,145601,4116,29450,2999,13324,2231
"283","22045","Iberia Parish, Louisiana",25386,1277,21667,1573,15983,1475,851,467,20816,1616,5684,1219,3719,1044
"284","22051","Jefferson Parish, Louisiana",167596,2590,148758,2989,117802,3223,7118,1092,141640,2835,30956,2711,18838,2260
"285","22055","Lafayette Parish, Louisiana",94002,2365,87650,2556,69708,3188,2224,894,85426,2679,17942,2387,6352,1234
"286","22057","Lafourche Parish, Louisiana",35838,1635,31235,1864,23496,1806,1037,480,30198,1975,7739,1235,4603,1008
"287","22063","Livingston Parish, Louisiana",49084,1957,46591,2238,37383,2905,1277,601,45314,2278,9208,2124,2493,1109
"288","22071","Orleans Parish, Louisiana",155104,2460,136292,3036,102675,2715,4976,991,131316,3046,33617,2227,18812,1695
"289","22073","Ouachita Parish, Louisiana",55599,2304,46102,2399,35740,2267,1659,676,44443,2525,10362,1377,9497,1692
"290","22079","Rapides Parish, Louisiana",48915,1824,43808,1887,33354,2150,2066,870,41742,1915,10454,1762,5107,972
"291","22097","St. Landry Parish, Louisiana",29965,1370,22198,1509,15049,1449,1747,573,20451,1497,7149,1338,7767,1437
"292","22103","St. Tammany Parish, Louisiana",93589,2098,87266,2306,74903,3001,3198,938,84068,2311,12363,1903,6323,1386
"293","22105","Tangipahoa Parish, Louisiana",47401,2208,41561,2109,31033,2361,2099,822,39462,2290,10528,1912,5840,1512
"294","22109","Terrebonne Parish, Louisiana",37911,1698,33356,1823,25686,2180,1357,576,31999,1880,7670,1585,4555,1118
"295","23001","Androscoggin County, Maine",44897,1416,40858,1770,34131,1675,3860,960,36998,1763,6727,1392,4039,1102
"296","23003","Aroostook County, Maine",29931,947,24859,1203,19798,1238,3181,635,21678,1201,5061,1017,5072,769
"297","23005","Cumberland County, Maine",123485,2256,114803,2679,106313,2707,6688,1285,108115,2799,8490,1546,8682,1503
"298","23011","Kennebec County, Maine",54299,1620,48313,2128,41227,2198,3711,687,44602,2098,7086,1351,5986,1306
"299","23019","Penobscot County, Maine",61765,1822,55648,1975,47231,1997,5232,1097,50416,2035,8417,1534,6117,1091
"300","23031","York County, Maine",88416,2661,81271,2647,72017,2752,6054,1025,75217,2682,9254,1585,7145,1493
"301","24001","Allegany County, Maryland",27190,1512,22813,1509,18197,1597,1415,455,21398,1443,4616,921,4377,803
"302","24003","Anne Arundel County, Maryland",212687,2121,201634,2664,185186,3417,7160,1282,194474,2852,16448,1975,11053,1684
"303","24005","Baltimore County, Maryland",313259,2930,290567,3774,258476,4404,13897,1701,276670,4050,32091,3062,22692,2418
"304","24009","Calvert County, Maryland",32145,1055,30005,1140,28162,1355,1041,408,28964,1234,1843,788,2140,675
"305","24013","Carroll County, Maryland",60371,1279,54985,1584,49931,1874,1693,447,53292,1611,5054,1149,5386,1045
"306","24015","Cecil County, Maryland",36620,1435,32638,1701,28594,1773,2214,675,30424,1665,4044,1066,3982,990
"307","24017","Charles County, Maryland",56947,1438,52393,1620,48005,1772,1846,613,50547,1573,4388,1195,4554,1283
"308","24021","Frederick County, Maryland",95903,1096,90147,1208,81926,2113,2955,635,87192,1417,8221,1535,5756,939
"309","24025","Harford County, Maryland",94802,1608,88394,1681,82044,1654,4069,809,84325,1771,6350,1217,6408,1182
"310","24027","Howard County, Maryland",116903,1234,113533,1489,105749,2323,2783,653,110750,1581,7784,1641,3370,1068
"311","24031","Montgomery County, Maryland",368334,3409,355634,3805,333012,4099,13815,1672,341819,3720,22622,2573,12700,1830
"312","24033","Prince George's County, Maryland",315759,2100,300957,3018,254744,4544,11947,1765,289010,3413,46213,3980,14802,2096
"313","24037","St. Mary's County, Maryland",41239,1509,37989,1619,34400,1694,2622,875,35367,1686,3589,960,3250,891
"314","24043","Washington County, Maryland",56306,1343,49775,1676,41658,1907,3338,920,46437,1807,8117,1308,6531,1128
"315","24045","Wicomico County, Maryland",38084,1426,33619,1696,27393,1865,1463,735,32156,1664,6226,1402,4465,1056
"316","24510","Baltimore city, Maryland",237204,3359,209555,3719,160335,4196,10164,1471,199391,3767,49220,3589,27649,2466
"317","25001","Barnstable County, Massachusetts",86671,2983,82135,3058,73541,3003,6215,1089,75920,3157,8594,1469,4536,1135
"318","25003","Berkshire County, Massachusetts",55212,1795,49658,1971,43997,1829,3672,709,45986,2022,5661,1189,5554,1122
"319","25005","Bristol County, Massachusetts",215132,2834,191400,2946,161916,3696,11006,1726,180394,3132,29484,2564,23732,2053
"320","25009","Essex County, Massachusetts",295481,2547,272551,3122,236058,3585,14420,1653,258131,3265,36493,2754,22930,1792
"321","25011","Franklin County, Massachusetts",30391,875,27669,974,23252,1054,2559,538,25110,1130,4417,919,2722,528
"322","25013","Hampden County, Massachusetts",178678,2153,155531,3237,127272,3819,9693,1448,145838,3282,28259,2673,23147,2239
"323","25015","Hampshire County, Massachusetts",58902,1585,54766,1712,50554,1745,4317,918,50449,1722,4212,882,4136,757
"324","25017","Middlesex County, Massachusetts",612224,4157,576986,4879,531534,5291,28501,2567,548485,5041,45452,3773,35238,3150
"325","25021","Norfolk County, Massachusetts",267880,2214,253430,2811,233202,3467,12579,1699,240851,3205,20228,2239,14450,1857
"326","25023","Plymouth County, Massachusetts",189304,3054,177735,3312,156006,3413,10821,1470,166914,3340,21729,2339,11569,1760
"327","25025","Suffolk County, Massachusetts",315049,3110,290693,3901,249143,5039,9458,1972,281235,4361,41550,3719,24356,2403
"328","25027","Worcester County, Massachusetts",308831,3525,285301,3563,250649,4251,16205,1826,269096,3901,34652,3275,23530,2440
"329","26005","Allegan County, Michigan",43992,1368,40002,1649,33086,1766,1874,650,38128,1551,6916,1028,3990,910
"330","26017","Bay County, Michigan",44469,1080,39830,1385,32690,1530,1945,552,37885,1487,7140,1176,4639,900
"331","26021","Berrien County, Michigan",64783,1365,58239,1756,48054,1968,3291,796,54948,1560,10185,1529,6544,972
"332","26025","Calhoun County, Michigan",53914,1330,49092,1513,37459,1689,3376,874,45716,1609,11633,1301,4822,777
"333","26037","Clinton County, Michigan",29783,784,27349,969,24133,1077,1292,318,26057,1029,3216,561,2434,576
"334","26045","Eaton County, Michigan",44879,934,42047,1028,35262,1097,2370,492,39677,1054,6785,1034,2832,620
"335","26049","Genesee County, Michigan",169469,2391,148428,3235,117481,3262,7822,1201,140606,3428,30947,2573,21041,2410
"336","26055","Grand Traverse County, Michigan",36782,1760,34629,1779,30660,1709,2342,687,32287,1894,3969,955,2153,691
"337","26065","Ingham County, Michigan",112170,2008,105801,2357,91109,2729,4414,866,101387,2476,14692,1835,6369,1043
"338","26073","Isabella County, Michigan",25367,975,23331,1101,19377,1192,1012,296,22319,1105,3954,705,2036,413
"339","26075","Jackson County, Michigan",62598,1720,56227,1676,43890,2387,3023,546,53204,1618,12337,1657,6371,1147
"340","26077","Kalamazoo County, Michigan",104234,1997,96664,2322,83787,3005,4871,911,91793,2331,12877,1881,7570,1265
"341","26081","Kent County, Michigan",244046,2669,226890,3228,192016,3534,9643,1565,217247,3535,34874,2869,17156,2079
"342","26087","Lapeer County, Michigan",33560,981,30172,1096,25178,1224,2143,633,28029,1256,4994,1090,3388,791
"343","26091","Lenawee County, Michigan",38388,1194,34700,1289,27835,1315,2121,586,32579,1361,6865,1014,3688,639
"344","26093","Livingston County, Michigan",72676,1122,69688,1312,62919,1637,3593,731,66095,1307,6769,1184,2988,666
"345","26099","Macomb County, Michigan",347508,2620,320507,3754,270254,3676,15643,1666,304864,3763,50253,3504,27001,2590
"346","26103","Marquette County, Michigan",26328,1167,23233,1304,20728,1298,1859,411,21374,1318,2505,570,3095,587
"347","26111","Midland County, Michigan",34091,844,29947,1169,25908,1378,1070,344,28877,1116,4039,853,4144,877
"348","26115","Monroe County, Michigan",61586,1101,55982,1366,47270,1748,3419,753,52563,1500,8712,1302,5604,1082
"349","26121","Muskegon County, Michigan",67196,1329,60713,1677,45866,1922,3750,832,56963,1779,14847,1615,6483,1062
"350","26125","Oakland County, Michigan",503645,3953,471392,4434,424357,5056,17941,2030,453451,4717,47035,3403,32253,2883
"351","26139","Ottawa County, Michigan",103438,1947,97207,2044,86289,2523,4146,934,93061,2130,10918,1982,6231,896
"352","26145","Saginaw County, Michigan",78740,1414,69340,2123,54540,2117,4600,1048,64740,2299,14800,1589,9400,1364
"353","26147","St. Clair County, Michigan",65751,1482,59093,1626,48532,1934,3021,667,56072,1612,10561,1449,6658,981
"354","26155","Shiawassee County, Michigan",28218,620,25877,900,19941,976,1428,397,24449,930,5936,947,2341,573
"355","26159","Van Buren County, Michigan",28607,1337,25847,1313,21438,1259,1365,593,24482,1304,4409,606,2760,560
"356","26161","Washtenaw County, Michigan",143072,1755,137406,2144,125861,2303,4364,915,133042,2361,11545,1467,5666,1042
"357","26163","Wayne County, Michigan",687546,4917,615308,5857,470602,6571,29633,2036,585675,6062,144706,5348,72238,4176
"358","27003","Anoka County, Minnesota",128140,1393,121430,1748,108964,2189,5355,978,116075,2077,12466,1804,6710,1300
"359","27013","Blue Earth County, Minnesota",26362,855,24699,1032,22023,1036,1236,374,23463,1069,2676,675,1663,520
"360","27019","Carver County, Minnesota",36925,929,35284,1031,32407,1192,936,326,34348,1149,2877,865,1641,482
"361","27037","Dakota County, Minnesota",162496,1249,155843,1685,141564,2223,5579,1009,150264,2057,14279,1562,6653,1178
"362","27053","Hennepin County, Minnesota",508964,3587,482143,4340,435251,4902,20825,2101,461318,4533,46892,3235,26821,2518
"363","27109","Olmsted County, Minnesota",63462,1096,59280,1448,52486,1861,2685,666,56595,1538,6794,1454,4182,863
"364","27123","Ramsey County, Minnesota",209287,2101,194490,2576,168912,3251,9756,1429,184734,2631,25578,2525,14797,1764
"365","27131","Rice County, Minnesota",23358,783,20971,941,18239,1028,1706,440,19265,907,2732,753,2387,694
"366","27137","St. Louis County, Minnesota",84370,1926,74214,2070,61146,2088,4555,725,69659,2167,13068,1487,10156,1164
"367","27139","Scott County, Minnesota",50040,1031,48144,1154,44732,1519,1081,415,47063,1250,3412,961,1896,554
"368","27141","Sherburne County, Minnesota",32033,865,30685,901,26810,1588,1069,497,29616,1035,3875,1302,1348,481
"369","27145","Stearns County, Minnesota",58510,1538,53763,1792,44244,1862,3244,823,50519,1916,9519,1510,4747,937
"370","27163","Washington County, Minnesota",96387,1277,91176,1530,83684,2187,3129,750,88047,1750,7492,1538,5211,986
"371","27171","Wright County, Minnesota",48863,843,44771,1075,38713,1355,2067,720,42704,1270,6058,1369,4092,811
"372","28033","DeSoto County, Mississippi",63075,1642,59578,1826,48534,2192,1225,431,58353,1768,11044,1477,3497,819
"373","28035","Forrest County, Mississippi",27248,1513,23146,1739,17306,1885,930,496,22216,1738,5840,1378,4102,1218
"374","28047","Harrison County, Mississippi",82375,2255,75683,2547,56655,3002,2040,704,73643,2633,19028,2204,6692,1453
"375","28049","Hinds County, Mississippi",85483,2220,76334,2319,56042,2454,3026,785,73308,2476,20292,2051,9149,1362
"376","28059","Jackson County, Mississippi",51659,2358,47455,2481,36782,2644,1662,774,45793,2410,10673,1824,4204,1136
"377","28067","Jones County, Mississippi",25098,1254,22634,1282,13622,1600,774,470,21860,1376,9012,1595,2464,879
"378","28075","Lauderdale County, Mississippi",29993,1432,25969,1695,19775,1792,721,392,25248,1771,6194,1557,4024,1018
"379","28081","Lee County, Mississippi",32527,1164,28293,1434,19454,1580,1511,566,26782,1488,8839,1490,4234,1088
"380","28089","Madison County, Mississippi",40229,1467,38604,1485,33950,1737,1603,778,37001,1584,4654,1078,1625,591
"381","28121","Rankin County, Mississippi",55483,1717,51464,2037,44216,2294,2025,722,49439,1996,7248,1766,4019,1117
"382","29019","Boone County, Missouri",72217,1620,69103,1895,60335,2569,2146,632,66957,2063,8768,1881,3114,938
"383","29021","Buchanan County, Missouri",33621,1285,30775,1378,23198,1480,1569,501,29206,1333,7577,1503,2846,573
"384","29031","Cape Girardeau County, Missouri",28675,1233,26153,1335,22259,1494,1090,460,25063,1355,3894,1087,2522,574
"385","29037","Cass County, Missouri",40197,905,37731,1239,32653,1396,1782,640,35949,1251,5078,1115,2466,779
"386","29043","Christian County, Missouri",31421,1196,28877,1112,23948,1494,777,373,28100,1175,4929,1112,2544,810
"387","29047","Clay County, Missouri",91901,1902,87715,2320,74687,2695,3564,738,84151,2254,13028,1904,4186,1128
"388","29051","Cole County, Missouri",29593,1324,27742,1357,22909,1386,1314,454,26428,1415,4833,1101,1851,576
"389","29071","Franklin County, Missouri",40387,1353,36712,1616,30973,1605,2239,793,34473,1743,5739,1460,3675,868
"390","29077","Greene County, Missouri",128691,1842,111790,2329,93444,3051,5161,1184,106629,2327,18346,2275,16901,2002
"391","29095","Jackson County, Missouri",288752,3533,267004,3736,219726,3749,12829,1720,254175,3897,47278,3693,21748,2148
"392","29097","Jasper County, Missouri",47846,957,42417,1341,31889,1431,2446,793,39971,1416,10528,1280,5429,1180
"393","29099","Jefferson County, Missouri",85892,1528,81341,1851,68923,2546,3654,1136,77687,2000,12418,1743,4551,994
"394","29165","Platte County, Missouri",40086,969,38824,1062,32919,1657,1613,593,37211,1178,5905,1509,1262,550
"395","29183","St. Charles County, Missouri",149951,1706,143088,2080,130546,2623,5717,980,137371,2242,12542,1908,6863,1262
"396","29187","St. Francois County, Missouri",25670,1485,21834,1733,17294,1875,712,335,21122,1722,4540,1277,3836,1005
"397","29189","St. Louis County, Missouri",408117,3880,378967,4284,327143,6118,15521,1732,363446,4118,51824,4029,29150,2611
"398","29510","St. Louis city, Missouri",144295,2502,125685,3341,93388,3536,6598,1114,119087,3132,32297,2581,18610,1922
"399","30013","Cascade County, Montana",35558,942,30878,1273,24824,1430,1744,574,29134,1346,6054,1096,4680,983
"400","30029","Flathead County, Montana",38372,1694,34876,1960,31296,2099,3096,715,31780,1854,3580,884,3496,967
"401","30031","Gallatin County, Montana",44423,1405,42082,1549,39062,1601,1803,622,40279,1621,3020,966,2341,882
"402","30049","Lewis and Clark County, Montana",27842,1037,24917,1163,22393,1410,1359,494,23558,1195,2524,784,2925,727
"403","30063","Missoula County, Montana",50401,1212,47923,1448,43181,1917,2459,708,45464,1633,4742,1254,2478,859
"404","30111","Yellowstone County, Montana",66805,1731,60700,2215,51947,2077,3378,787,57322,2332,8753,1343,6105,1491
"405","31055","Douglas County, Nebraska",220858,2346,204483,2884,176028,2932,10179,1329,194304,2814,28455,2310,16375,1913
"406","31109","Lancaster County, Nebraska",125917,1786,118576,2348,104557,2706,5776,907,112800,2221,14019,1819,7341,1518
"407","31153","Sarpy County, Nebraska",66273,1240,63305,1393,56836,1590,2160,641,61145,1422,6469,1225,2968,740
"408","32003","Clark County, Nevada",808605,5626,755963,6963,639070,8943,28763,2350,727200,7197,116893,5976,52642,3597
"409","32031","Washoe County, Nevada",185709,2535,176054,2776,153218,3249,7903,1450,168151,2904,22836,2501,9655,1281
"410","33005","Cheshire County, New Hampshire",30208,1282,27152,1486,23867,1704,2345,623,24807,1434,3285,947,3056,811
"411","33009","Grafton County, New Hampshire",35394,1623,32576,1704,29165,1751,2948,585,29628,1785,3411,960,2818,683
"412","33011","Hillsborough County, New Hampshire",161649,2405,152929,2597,135191,3187,7512,1214,145417,2870,17738,2271,8720,1410
"413","33013","Merrimack County, New Hampshire",58521,1287,55097,1480,50494,1629,4615,975,50482,1623,4603,997,3424,945
"414","33015","Rockingham County, New Hampshire",119467,2346,114561,2556,105697,2762,6466,1058,108095,2760,8864,1656,4906,1219
"415","33017","Strafford County, New Hampshire",48393,1525,45144,1701,41251,1892,2175,693,42969,1758,3893,1065,3249,876
"416","34001","Atlantic County, New Jersey",96981,2649,90877,2687,76112,2582,4918,1038,85959,2826,14765,2233,6104,1067
"417","34003","Bergen County, New Jersey",339953,2811,318296,3538,287910,3946,12026,1616,306270,3474,30386,2940,21657,2306
"418","34005","Burlington County, New Jersey",166698,3189,156495,3354,141172,3684,7469,1274,149026,3509,15323,2103,10203,1400
"419","34007","Camden County, New Jersey",188840,2558,172891,3140,144953,3586,9028,1218,163863,3094,27938,2793,15949,1711
"420","34009","Cape May County, New Jersey",39208,2517,36467,2575,33301,2440,2928,678,33539,2445,3166,749,2741,757
"421","34011","Cumberland County, New Jersey",50034,1841,44617,1999,36827,2006,2541,923,42076,2020,7790,1383,5417,1115
"422","34013","Essex County, New Jersey",289921,2891,266330,3928,213513,4476,9598,1406,256732,3792,52817,3563,23591,2486
"423","34015","Gloucester County, New Jersey",101414,2242,95140,2410,85475,2250,5050,980,90090,2644,9665,1743,6274,1106
"424","34017","Hudson County, New Jersey",263924,2261,246399,2727,212675,3666,6155,1242,240244,2921,33724,2885,17525,1670
"425","34019","Hunterdon County, New Jersey",47733,966,45515,1321,42626,1350,2056,516,43459,1346,2889,829,2218,696
"426","34021","Mercer County, New Jersey",132980,1977,124528,2576,106954,3483,6289,1516,118239,2744,17574,2823,8452,1465
"427","34023","Middlesex County, New Jersey",285480,3044,269001,3652,236119,4117,11571,1577,257430,3879,32882,3075,16479,2281
"428","34025","Monmouth County, New Jersey",236327,2742,221863,3202,202031,3942,10214,1543,211649,3626,19832,2434,14464,2035
"429","34027","Morris County, New Jersey",181738,2277,172181,2781,162311,3104,8168,1285,164013,2935,9870,1667,9557,1455
"430","34029","Ocean County, New Jersey",228622,3160,205540,3747,184348,4571,18854,2033,186686,3836,21192,2587,23082,2564
"431","34031","Passaic County, New Jersey",169521,1773,156615,2438,127367,3225,4404,912,152211,2616,29248,2868,12906,1721
"432","34033","Salem County, New Jersey",23952,1015,22042,1070,17896,1237,1004,391,21038,1058,4146,1024,1910,623
"433","34035","Somerset County, New Jersey",118729,1954,114618,2043,107325,2042,3831,965,110787,2154,7293,1479,4111,878
"434","34037","Sussex County, New Jersey",53749,1618,51259,1766,47897,1844,2075,599,49184,1775,3362,817,2490,857
"435","34039","Union County, New Jersey",192021,2054,174469,3060,151437,3707,7433,1373,167036,3315,23032,2885,17552,2253
"436","34041","Warren County, New Jersey",41742,1111,37737,1420,33116,1449,3088,831,34649,1587,4621,1100,4005,996
"437","35001","Bernalillo County, New Mexico",270655,3583,250248,4174,206795,4903,12260,1832,237988,4363,43453,3917,20407,2100
"438","35005","Chaves County, New Mexico",22616,1260,19376,1337,14664,1504,1432,595,17944,1288,4712,1127,3240,1075
"439","35013","Doña Ana County, New Mexico",80409,1710,70212,1999,53994,2674,2821,903,67391,1957,16218,2439,10197,1605
"440","35025","Lea County, New Mexico",23215,968,21057,1059,14277,1383,337,317,20720,1139,6780,1044,2158,777
"441","35031","McKinley County, New Mexico",21449,655,13598,974,7655,880,670,437,12928,984,5943,948,7851,944
"442","35035","Otero County, New Mexico",23747,1492,21840,1678,18749,1773,1588,736,20252,1800,3091,1026,1907,764
"443","35043","Sandoval County, New Mexico",53996,1032,48489,1245,41345,1380,3249,793,45240,1576,7144,1131,5507,1010
"444","35045","San Juan County, New Mexico",43707,1245,36996,1366,29912,1461,2980,890,34016,1635,7084,1202,6711,906
"445","35049","Santa Fe County, New Mexico",62707,1541,55119,1730,47674,1972,2813,704,52306,1745,7445,1398,7588,1064
"446","35061","Valencia County, New Mexico",28379,1042,25003,1286,19455,1770,1463,615,23540,1305,5548,1403,3376,909
"447","36001","Albany County, New York",126578,2481,114748,3115,96953,3532,6417,1120,108331,3093,17795,2368,11830,1616
"448","36005","Bronx County, New York",507370,2944,449984,4415,311163,6488,15637,1937,434347,4541,138821,5742,57386,3296
"449","36007","Broome County, New York",75539,2336,68759,2371,58401,2559,5817,1159,62942,2471,10358,1773,6780,1207
"450","36009","Cattaraugus County, New York",32079,1105,26799,1396,21721,1388,2195,534,24604,1414,5078,1001,5280,829
"451","36011","Cayuga County, New York",30083,1041,26806,1112,21876,1257,2202,651,24604,1168,4930,942,3277,564
"452","36013","Chautauqua County, New York",53429,1794,46451,1773,39962,1662,4632,817,41819,1812,6489,1111,6978,1051
"453","36015","Chemung County, New York",34325,1210,30456,1555,24766,1536,1942,689,28514,1575,5690,1220,3869,997
"454","36019","Clinton County, New York",31392,1414,28840,1513,25556,1683,2464,660,26376,1509,3284,960,2552,520
"455","36027","Dutchess County, New York",108071,2214,101278,2440,88840,2715,6525,1129,94753,2441,12438,1851,6793,1092
"456","36029","Erie County, New York",390341,4209,349864,4929,292350,4737,23737,2396,326127,5159,57514,4003,40477,2842
"457","36045","Jefferson County, New York",44657,1987,40785,2013,34308,2006,1624,582,39161,2053,6477,1276,3872,764
"458","36047","Kings County, New York",969317,5651,862989,6367,741849,7594,32798,2644,830191,6017,121140,5213,106328,5352
"459","36051","Livingston County, New York",23746,1054,21860,1222,19185,1271,1443,563,20417,1202,2675,660,1886,621
"460","36053","Madison County, New York",26127,1315,23602,1353,20210,1234,1213,392,22389,1283,3392,919,2525,587
"461","36055","Monroe County, New York",301668,2889,275770,3677,233686,3987,15581,1855,260189,3985,42084,2893,25898,2141
"462","36059","Nassau County, New York",447123,3118,421870,3795,388050,4209,20268,2124,401602,3806,33820,3142,25253,2237
"463","36061","New York County, New York",752258,9358,695861,10528,629554,10870,23304,3176,672557,10866,66307,5468,56397,4999
"464","36063","Niagara County, New York",89765,1815,79356,2164,66897,2441,5414,1026,73942,2274,12459,1745,10409,1459
"465","36065","Oneida County, New York",88871,1761,79346,2128,68169,2201,4171,900,75175,2150,11177,1641,9525,1519
"466","36067","Onondaga County, New York",185046,2584,163493,2975,142982,3575,12064,1796,151429,3232,20511,2224,21553,2063
"467","36069","Ontario County, New York",44079,1553,40692,1622,36959,1523,2366,554,38326,1732,3733,744,3387,889
"468","36071","Orange County, New York",128259,2556,116218,2801,96913,2982,6871,1259,109347,2726,19305,2107,12041,1830
"469","36075","Oswego County, New York",46270,1427,41390,1724,35395,1713,2831,633,38559,1779,5995,921,4880,1076
"470","36079","Putnam County, New York",35425,1053,33517,1286,30902,1334,1733,574,31784,1364,2615,912,1908,731
"471","36081","Queens County, New York",788110,4493,727774,5200,606562,6340,28818,2149,698956,5495,121212,5206,60336,3754
"472","36083","Rensselaer County, New York",64614,1585,60061,1928,51306,2139,4443,1054,55618,2062,8755,1497,4553,1034
"473","36085","Richmond County, New York",167441,2183,153692,3153,133409,3476,8458,1366,145234,3064,20283,2374,13749,2291
"474","36087","Rockland County, New York",99502,1638,88477,2166,78948,2461,5536,1037,82941,2079,9529,1933,11025,1592
"475","36089","St. Lawrence County, New York",41680,1492,36032,1601,29865,1642,3038,717,32994,1762,6167,1098,5648,971
"476","36091","Saratoga County, New York",94156,2358,88679,2295,79678,2945,5307,1203,83372,2468,9001,1999,5477,869
"477","36093","Schenectady County, New York",55262,2067,50432,2208,41287,2198,3522,915,46910,2239,9145,1521,4830,946
"478","36101","Steuben County, New York",40578,1158,35590,1363,30328,1372,3237,606,32353,1338,5262,940,4988,680
"479","36103","Suffolk County, New York",496784,4540,467856,4736,429325,5463,25905,2587,441951,5096,38531,3271,28928,2649
"480","36105","Sullivan County, New York",28900,1706,25630,1756,20609,1535,2210,662,23420,1723,5021,1301,3270,790
"481","36109","Tompkins County, New York",40250,1478,38483,1532,34872,1788,2521,708,35962,1711,3611,938,1767,657
"482","36111","Ulster County, New York",69154,2116,64596,2373,56015,2557,4293,826,60303,2422,8581,1447,4558,930
"483","36113","Warren County, New York",28007,1304,24347,1387,21096,1421,2741,703,21606,1490,3251,868,3660,934
"484","36117","Wayne County, New York",35927,1087,31970,1310,26869,1470,1859,637,30111,1259,5101,888,3957,899
"485","36119","Westchester County, New York",352498,3458,327815,4184,286769,4727,14649,1876,313166,3965,41046,3297,24683,2547
"486","37001","Alamance County, North Carolina",64700,1430,57378,2113,47347,2119,2638,767,54740,2124,10031,1594,7322,1406
"487","37019","Brunswick County, North Carolina",56752,2253,53603,2199,46203,2147,3431,796,50172,2356,7400,1152,3149,660
"488","37021","Buncombe County, North Carolina",108411,2722,96027,2973,78944,3191,3535,842,92492,2860,17083,2303,12384,1913
"489","37023","Burke County, North Carolina",36157,1207,31861,1467,23378,1875,2718,935,29143,1764,8483,1583,4296,885
"490","37025","Cabarrus County, North Carolina",73751,1669,70142,1805,62378,2270,2780,795,67362,1864,7764,1618,3609,955
"491","37027","Caldwell County, North Carolina",31544,1404,27293,1624,19983,1493,1619,563,25674,1631,7310,1412,4251,876
"492","37031","Carteret County, North Carolina",28720,1584,26753,1538,23065,1564,1324,374,25429,1599,3688,752,1967,480
"493","37035","Catawba County, North Carolina",62861,1748,56607,1953,45996,1999,3025,707,53582,1870,10611,1660,6254,1393
"494","37037","Chatham County, North Carolina",28343,1301,25874,1285,23021,1275,1623,545,24251,1376,2853,755,2469,784
"495","37045","Cleveland County, North Carolina",34574,1537,28405,1722,22122,1866,2121,755,26284,1790,6283,1256,6169,1151
"496","37049","Craven County, North Carolina",40412,1567,37486,1766,31099,2088,2005,683,35481,1914,6387,1387,2926,983
"497","37051","Cumberland County, North Carolina",127911,2211,117600,2469,96755,2516,4565,843,113035,2587,20845,1918,10311,1312
"498","37057","Davidson County, North Carolina",68761,1714,61118,2139,49103,2488,3671,940,57447,2033,12015,1938,7643,1267
"499","37063","Durham County, North Carolina",127527,2442,121670,2716,106502,3248,3416,971,118254,2945,15168,2427,5857,1068
"500","37067","Forsyth County, North Carolina",150437,2389,138253,2613,110005,2866,5649,1177,132604,2710,28248,2846,12184,1650
"501","37069","Franklin County, North Carolina",26380,1057,23339,1319,19800,1471,949,408,22390,1354,3539,1013,3041,942
"502","37071","Gaston County, North Carolina",84999,1888,75886,2046,62812,2171,4853,937,71033,2406,13074,1854,9113,1289
"503","37081","Guilford County, North Carolina",209842,2869,189359,3194,161557,3481,9993,1933,179366,3246,27802,2997,20483,2286
"504","37085","Harnett County, North Carolina",46015,1387,42502,1475,35295,1656,1650,531,40852,1603,7207,1104,3513,799
"505","37089","Henderson County, North Carolina",49514,1551,44766,1741,37716,1863,2708,732,42058,1812,7050,1254,4748,1084
"506","37097","Iredell County, North Carolina",68328,1398,62711,1797,54390,2015,2844,705,59867,1772,8321,1330,5617,1241
"507","37101","Johnston County, North Carolina",70001,1947,64027,2144,54955,2405,2751,1035,61276,2322,9072,1766,5974,1448
"508","37109","Lincoln County, North Carolina",34233,909,31886,1106,25998,1463,841,394,31045,1191,5888,1323,2347,678
"509","37119","Mecklenburg County, North Carolina",418135,4115,400351,4268,351007,5727,12185,1835,388166,4366,49344,3679,17784,1862
"510","37125","Moore County, North Carolina",40756,1706,36601,2143,32532,2044,2517,742,34084,2115,4069,1204,4155,1213
"511","37127","Nash County, North Carolina",37767,1458,33542,1841,26701,1995,2259,814,31283,1901,6841,1535,4225,1087
"512","37129","New Hanover County, North Carolina",98151,2425,93018,2594,82421,3051,3257,992,89761,2670,10597,1776,5133,1142
"513","37133","Onslow County, North Carolina",66834,2424,64394,2565,56454,3435,2011,804,62383,2541,7940,2355,2440,873
"514","37135","Orange County, North Carolina",53959,1460,50631,1855,47455,1874,1553,448,49078,1790,3176,925,3328,1062
"515","37147","Pitt County, North Carolina",69288,2143,62255,2350,52237,2466,2071,852,60184,2498,10018,1584,7033,1151
"516","37151","Randolph County, North Carolina",54783,1754,49837,1926,38954,2201,2877,915,46960,2086,10883,1618,4946,928
"517","37155","Robeson County, North Carolina",46026,984,38868,1186,25825,1501,2006,504,36862,1226,13043,1316,7158,779
"518","37157","Rockingham County, North Carolina",37476,1540,28486,1808,23396,1791,2426,732,26060,1759,5090,1051,8990,1470
"519","37159","Rowan County, North Carolina",53806,1929,47046,2293,37229,2154,2737,912,44309,2404,9817,1605,6760,1271
"520","37161","Rutherford County, North Carolina",26305,1704,22134,1907,18108,1622,1417,577,20717,1868,4026,1031,4171,991
"521","37171","Surry County, North Carolina",29230,1096,23524,1168,18718,1255,1683,535,21841,1323,4806,1101,5706,926
"522","37179","Union County, North Carolina",77696,1503,73978,1740,63635,2099,2114,643,71864,1732,10343,1565,3718,874
"523","37183","Wake County, North Carolina",408473,3824,396038,3932,360673,5045,10211,1516,385827,3837,35365,3575,12435,2089
"524","37191","Wayne County, North Carolina",49019,1504,42724,1676,30849,1882,2356,873,40368,1703,11875,1545,6295,1060
"525","37193","Wilkes County, North Carolina",30123,1023,25891,1499,20512,1773,2272,891,23619,1620,5379,1223,4232,1091
"526","37195","Wilson County, North Carolina",31817,1072,26628,1316,19508,1652,1662,707,24966,1329,7120,1358,5189,1134
"527","38015","Burleigh County, North Dakota",40736,1163,37729,1372,33766,1440,1735,569,35994,1437,3963,868,3007,1031
"528","38017","Cass County, North Dakota",74343,2610,69466,2901,60476,3279,2461,859,67005,3016,8990,1789,4877,1208
"529","38035","Grand Forks County, North Dakota",30916,958,28146,1159,23796,1586,740,387,27406,1214,4350,1158,2770,727
"530","38101","Ward County, North Dakota",27887,1494,24927,1852,20020,1688,1077,477,23850,1783,4907,1259,2960,1120
"531","39003","Allen County, Ohio",41204,1056,36955,1172,29992,1573,2608,644,34347,1351,6963,1278,4249,966
"532","39007","Ashtabula County, Ohio",35445,1483,29614,1720,22846,1727,2552,700,27062,1508,6768,1144,5831,954
"533","39009","Athens County, Ohio",22533,1137,19965,1260,16776,1371,1443,528,18522,1358,3189,790,2568,712
"534","39013","Belmont County, Ohio",24742,1335,20117,1243,16257,1225,1139,402,18978,1203,3860,899,4625,737
"535","39017","Butler County, Ohio",143040,2130,132630,2576,110931,3254,5398,1044,127232,2626,21699,2297,10410,1592
"536","39023","Clark County, Ohio",55327,1237,50284,1480,39277,1623,3111,630,47173,1455,11007,1401,5043,921
"537","39025","Clermont County, Ohio",77920,1672,72215,2067,65377,2150,3721,859,68494,2124,6838,1509,5705,1198
"538","39029","Columbiana County, Ohio",41884,1180,36332,1513,28090,1660,2039,664,34293,1564,8242,1306,5552,1028
"539","39035","Cuyahoga County, Ohio",542122,4648,484796,4756,393145,5280,26508,2070,458288,5467,91651,3810,57326,3270
"540","39041","Delaware County, Ohio",70501,1376,69078,1374,63698,1597,1943,520,67135,1535,5380,1108,1423,443
"541","39043","Erie County, Ohio",31675,1177,28788,1470,24543,1547,2869,770,25919,1576,4245,1115,2887,937
"542","39045","Fairfield County, Ohio",55934,1413,51556,1685,45099,1813,3388,868,48168,1878,6457,1371,4378,1005
"543","39049","Franklin County, Ohio",519468,4049,487921,4744,406115,6052,16639,1773,471282,4870,81806,5240,31547,3093
"544","39055","Geauga County, Ohio",35387,804,31533,1174,27906,1317,1656,569,29877,1201,3627,918,3854,870
"545","39057","Greene County, Ohio",66053,1401,61005,1813,53485,1869,2174,545,58831,1907,7520,1266,5048,985
"546","39061","Hamilton County, Ohio",344562,3568,314575,3991,265210,4817,14990,1517,299585,3973,49365,3349,29987,2589
"547","39063","Hancock County, Ohio",31606,1123,29276,1266,23841,1665,1811,706,27465,1482,5435,1314,2330,707
"548","39081","Jefferson County, Ohio",27292,1192,22011,1405,16721,1228,1549,415,20462,1396,5290,1020,5281,770
"549","39085","Lake County, Ohio",96577,1608,90290,1795,78743,1865,5383,1009,84907,1866,11547,1527,6287,889
"550","39089","Licking County, Ohio",62237,1461,57298,1813,50041,1926,2991,815,54307,1960,7257,1221,4939,1117
"551","39093","Lorain County, Ohio",121344,1986,113148,2277,99261,2781,9607,1535,103541,2581,13887,1973,8196,1424
"552","39095","Lucas County, Ohio",178289,2709,161733,3393,125965,3897,7710,1089,154023,3534,35768,3245,16556,1973
"553","39099","Mahoning County, Ohio",97365,2155,86026,2353,68809,2585,6366,1112,79660,2325,17217,1764,11339,1300
"554","39101","Marion County, Ohio",24205,1039,21948,1172,16105,1391,1265,556,20683,1201,5843,1179,2257,637
"555","39103","Medina County, Ohio",70609,1062,66715,1317,60634,1816,2953,683,63762,1445,6081,1266,3894,920
"556","39109","Miami County, Ohio",41148,996,37220,1257,30783,1785,2432,791,34788,1267,6437,1550,3928,877
"557","39113","Montgomery County, Ohio",224225,3304,203538,3707,164068,4258,10956,1313,192582,4154,39470,3216,20687,2145
"558","39119","Muskingum County, Ohio",34471,1189,30345,1292,24780,1289,2333,689,28012,1479,5565,1094,4126,778
"559","39133","Portage County, Ohio",60801,1712,55835,1910,48678,2055,3061,788,52774,1942,7157,1364,4966,854
"560","39139","Richland County, Ohio",48105,1434,40628,1693,33683,1769,3485,905,37143,1754,6945,1180,7477,1206
"561","39141","Ross County, Ohio",29779,1145,26239,1342,21149,1581,2055,617,24184,1323,5090,1124,3540,842
"562","39145","Scioto County, Ohio",28719,1277,25187,1466,19349,1451,970,397,24217,1445,5838,1236,3532,804
"563","39151","Stark County, Ohio",152210,2357,136562,2929,110194,3116,6633,881,129929,2827,26368,2148,15648,1739
"564","39153","Summit County, Ohio",226243,2658,205924,3225,173499,3578,12342,1599,193582,3313,32425,3018,20319,2438
"565","39155","Trumbull County, Ohio",83303,2086,72800,2452,58046,2438,4741,952,68059,2422,14754,1855,10503,1641
"566","39157","Tuscarawas County, Ohio",36740,1304,32281,1342,23724,1455,1827,479,30454,1365,8557,1428,4459,981
"567","39165","Warren County, Ohio",83540,1571,80591,1867,73715,2281,2482,847,78109,1854,6876,1299,2949,846
"568","39169","Wayne County, Ohio",43908,943,37666,1115,32881,1209,2381,521,35285,1172,4785,882,6242,877
"569","39173","Wood County, Ohio",50694,1077,47790,1406,41352,1759,2542,726,45248,1517,6438,1336,2904,816
"570","40017","Canadian County, Oklahoma",45344,1016,42784,1237,37756,1455,1513,496,41271,1269,5028,953,2560,712
"571","40027","Cleveland County, Oklahoma",110775,1611,104885,1831,90744,2505,3420,799,101465,1937,14141,1851,5890,1043
"572","40031","Comanche County, Oklahoma",42489,2060,39368,2006,30891,2182,1749,644,37619,1919,8477,1490,3121,829
"573","40037","Creek County, Oklahoma",26957,603,24167,683,18235,935,1417,453,22750,760,5932,673,2790,476
"574","40101","Muskogee County, Oklahoma",26566,768,22845,974,17853,1113,782,299,22063,979,4992,777,3721,682
"575","40109","Oklahoma County, Oklahoma",302645,2997,277983,3797,219445,4466,10703,1455,267280,3918,58538,3834,24662,2629
"576","40119","Payne County, Oklahoma",30734,1244,28837,1281,23691,1475,1172,416,27665,1384,5146,1085,1897,556
"577","40125","Pottawatomie County, Oklahoma",26714,648,23730,794,17864,972,1166,373,22564,752,5866,754,2984,538
"578","40131","Rogers County, Oklahoma",35254,773,33299,791,26519,1013,1458,353,31841,896,6780,758,1955,412
"579","40143","Tulsa County, Oklahoma",250492,1605,232795,1660,188839,2321,8562,987,224233,1968,43956,2058,17697,1353
"580","40145","Wagoner County, Oklahoma",30186,459,28356,671,23878,895,927,247,27429,667,4478,696,1830,492
"581","41003","Benton County, Oregon",35520,1096,34172,1169,31678,1402,1451,471,32721,1221,2494,777,1348,529
"582","41005","Clackamas County, Oregon",158749,1775,151173,2015,139470,2585,8190,1365,142983,2354,11703,2020,7576,1547
"583","41017","Deschutes County, Oregon",79950,2076,76811,2378,70078,2570,3113,1034,73698,2385,6733,1479,3139,1051
"584","41019","Douglas County, Oregon",45647,1374,41312,1419,36192,1597,3827,962,37485,1665,5120,1179,4335,1038
"585","41029","Jackson County, Oregon",89787,1615,85224,1779,72262,2436,3850,1013,81374,2119,12962,1897,4563,994
"586","41033","Josephine County, Oregon",37059,980,34437,1219,28404,1994,2875,751,31562,1328,6033,1617,2622,757
"587","41035","Klamath County, Oregon",26798,1202,24545,1238,19558,1330,1539,455,23006,1387,4987,988,2253,608
"588","41039","Lane County, Oregon",156072,1587,147852,2086,129557,2673,9006,1555,138846,2374,18295,2053,8220,1274
"589","41043","Linn County, Oregon",48464,952,45112,1233,38094,1568,2509,922,42603,1305,7018,1131,3352,1007
"590","41047","Marion County, Oregon",119511,1759,113504,2333,93554,2799,5584,1065,107920,2557,19950,2215,6007,1455
"591","41051","Multnomah County, Oregon",330223,3141,313993,3854,278785,4645,9919,1331,304074,4039,35208,3686,16230,2135
"592","41053","Polk County, Oregon",31218,856,29947,1003,26033,1449,1757,662,28190,1094,3914,1065,1271,566
"593","41059","Umatilla County, Oregon",26048,1304,23525,1377,19663,1409,976,412,22549,1485,3862,926,2523,819
"594","41067","Washington County, Oregon",225955,2051,219361,2532,199725,3137,7970,1429,211391,2607,19636,2362,6594,1522
"595","41071","Yamhill County, Oregon",37235,860,34198,1218,30714,1346,2138,686,32060,1222,3484,1089,3037,934
"596","42001","Adams County, Pennsylvania",39570,857,35438,994,30095,1208,2662,568,32776,1003,5343,858,4132,659
"597","42003","Allegheny County, Pennsylvania",543369,4280,492748,5079,423214,6518,27875,2267,464873,5223,69534,4703,50621,3552
"598","42005","Armstrong County, Pennsylvania",27332,742,23305,803,19398,828,2027,504,21278,980,3907,590,4027,497
"599","42007","Beaver County, Pennsylvania",73059,1422,65150,1592,53728,2146,4732,839,60418,1760,11422,1592,7909,971
"600","42011","Berks County, Pennsylvania",157006,1788,140835,2153,116958,2372,8395,1374,132440,2473,23877,2591,16171,1903
"601","42013","Blair County, Pennsylvania",51096,1366,44563,1471,36405,1627,3524,710,41039,1559,8158,1375,6533,1089
"602","42017","Bucks County, Pennsylvania",239962,2009,224426,2819,204804,3470,10311,1402,214115,2925,19622,2269,15536,1895
"603","42019","Butler County, Pennsylvania",77764,1516,69909,1703,60829,1877,4482,829,65427,1631,9080,1229,7855,1133
"604","42021","Cambria County, Pennsylvania",56483,1494,47274,1622,38595,1760,4282,731,42992,1600,8679,1018,9209,1121
"605","42025","Carbon County, Pennsylvania",25177,1435,22212,1388,18196,1430,2232,884,19980,1538,4016,1073,2965,677
"606","42027","Centre County, Pennsylvania",58514,1797,54021,1852,49856,1987,4043,1056,49978,1920,4165,771,4493,835
"607","42029","Chester County, Pennsylvania",192746,1895,181591,2208,166158,2983,7764,1229,173827,2626,15433,2160,11155,1550
"608","42033","Clearfield County, Pennsylvania",31992,1190,27618,1241,23184,1268,2617,597,25001,1232,4434,793,4374,577
"609","42037","Columbia County, Pennsylvania",26655,931,23104,1160,19198,1106,2243,548,20861,1224,3906,833,3551,815
"610","42039","Crawford County, Pennsylvania",34386,1219,30534,1271,25667,1353,3040,489,27494,1330,4867,896,3852,465
"611","42041","Cumberland County, Pennsylvania",102243,1505,93642,2134,85091,2246,6193,1196,87449,2397,8551,1648,8601,1509
"612","42043","Dauphin County, Pennsylvania",112559,2336,100349,2955,82698,3126,7053,1133,93296,3013,17651,2362,12210,1968
"613","42045","Delaware County, Pennsylvania",207499,2560,192335,3102,164158,3568,9066,1298,183269,3266,28177,2744,15164,1781
"614","42049","Erie County, Pennsylvania",109797,2244,99226,2406,80567,2742,6246,1100,92980,2319,18659,2091,10571,1486
"615","42051","Fayette County, Pennsylvania",56085,1508,46577,1710,36597,1814,3227,637,43350,1725,9980,1215,9508,1412
"616","42055","Franklin County, Pennsylvania",59834,1413,52587,1558,45347,1763,4266,1165,48321,1690,7240,1323,7247,1080
"617","42063","Indiana County, Pennsylvania",33098,1741,28166,1780,24232,1941,2715,656,25451,1648,3934,760,4932,841
"618","42069","Lackawanna County, Pennsylvania",88268,1973,78054,2314,65752,2337,4575,909,73479,2223,12302,1689,10214,1407
"619","42071","Lancaster County, Pennsylvania",202490,2374,178584,2929,156746,3510,11255,1407,167329,3175,21838,2242,23906,2359
"620","42073","Lawrence County, Pennsylvania",37497,974,33138,1182,27459,1262,2264,551,30874,1234,5679,908,4359,717
"621","42075","Lebanon County, Pennsylvania",54522,1090,48370,1420,41084,1541,3707,740,44663,1485,7286,1219,6152,1171
"622","42077","Lehigh County, Pennsylvania",138586,1987,125750,2472,105885,2769,6125,1186,119625,2521,19865,2501,12836,1582
"623","42079","Luzerne County, Pennsylvania",128301,2438,111582,2824,88146,2868,7795,1126,103787,2844,23436,2427,16719,1615
"624","42081","Lycoming County, Pennsylvania",44585,1610,39568,1587,33385,1719,3403,695,36165,1612,6183,1164,5017,899
"625","42085","Mercer County, Pennsylvania",46809,1393,40032,1599,33107,1747,2958,592,37074,1547,6925,1235,6777,1079
"626","42089","Monroe County, Pennsylvania",55109,2594,51142,2750,45445,2477,3429,1000,47713,2666,5697,1332,3967,1088
"627","42091","Montgomery County, Pennsylvania",313336,2722,297278,3456,271697,3709,13201,1588,284077,3428,25581,2264,16058,1994
"628","42095","Northampton County, Pennsylvania",114996,1756,103676,2343,90104,2640,5903,937,97773,2395,13572,1755,11320,1523
"629","42097","Northumberland County, Pennsylvania",38816,1175,32302,1450,25779,1475,2558,508,29744,1426,6523,992,6514,1069
"630","42101","Philadelphia County, Pennsylvania",608233,5554,535555,6356,418611,8103,22311,2464,513244,6914,116944,6993,72678,3379
"631","42107","Schuylkill County, Pennsylvania",58458,1601,48816,1598,41113,1581,4209,748,44607,1688,7703,1141,9642,1193
"632","42111","Somerset County, Pennsylvania",28796,1255,23338,1398,19502,1311,2493,480,20845,1462,3836,629,5458,826
"633","42125","Washington County, Pennsylvania",85835,1617,76469,1806,64066,1957,4352,805,72117,1866,12403,1533,9366,1059
"634","42129","Westmoreland County, Pennsylvania",150368,2541,134120,2668,115450,2605,10098,1381,124022,2744,18670,1946,16248,1581
"635","42133","York County, Pennsylvania",173958,2155,157877,2786,132650,3033,8322,1140,149555,2739,25227,2611,16081,1855
"636","44003","Kent County, Rhode Island",69115,1534,62650,1986,55855,2413,3347,762,59303,2159,6795,1687,6465,1270
"637","44005","Newport County, Rhode Island",34316,1563,31736,1625,28803,1680,2619,697,29117,1782,2933,929,2580,616
"638","44007","Providence County, Rhode Island",237038,3238,207634,3496,168688,4106,10561,1549,197073,3520,38946,3009,29404,2761
"639","44009","Washington County, Rhode Island",47680,1937,45424,1868,41024,2060,2280,749,43144,1962,4400,1233,2256,819
"640","45003","Aiken County, South Carolina",68609,1761,61741,2254,48013,2543,2974,960,58767,2353,13728,2258,6868,1538
"641","45007","Anderson County, South Carolina",78500,2174,70796,2466,54876,2710,3479,856,67317,2435,15920,1961,7704,1346
"642","45013","Beaufort County, South Carolina",74679,2333,71091,2537,59795,2572,1926,731,69165,2627,11296,1911,3588,1281
"643","45015","Berkeley County, South Carolina",78168,1608,72804,1841,60738,2489,4282,1234,68522,2090,12066,1907,5364,1117
"644","45019","Charleston County, South Carolina",160457,3059,151084,3167,119649,3810,4461,925,146623,3306,31435,3008,9373,1831
"645","45031","Darlington County, South Carolina",25308,1306,19772,1666,14170,1561,1408,650,18364,1670,5602,1231,5536,1155
"646","45035","Dorchester County, South Carolina",55799,1577,53575,1523,45152,2142,2090,887,51485,1699,8423,1606,2224,762
"647","45041","Florence County, South Carolina",50518,1949,44153,2197,34037,2190,2097,580,42056,2237,10116,1569,6365,1141
"648","45045","Greenville County, South Carolina",192556,2659,176584,2972,148036,3457,7922,1319,168662,2931,28548,2425,15972,2166
"649","45047","Greenwood County, South Carolina",27962,1123,23532,1632,16971,1572,1308,421,22224,1598,6561,1085,4430,1254
"650","45051","Horry County, South Carolina",131180,3804,122384,3815,98929,3524,6346,1235,116038,4034,23455,2718,8796,1707
"651","45055","Kershaw County, South Carolina",24756,1186,22514,1288,19156,1371,1430,585,21084,1310,3358,916,2242,711
"652","45057","Lancaster County, South Carolina",35710,1145,32816,1317,25727,1609,1328,669,31488,1404,7089,1395,2894,811
"653","45059","Laurens County, South Carolina",25423,1349,20856,1695,15226,1593,986,357,19870,1698,5630,1158,4567,981
"654","45063","Lexington County, South Carolina",115566,2175,106203,2631,89089,2570,3620,737,102583,2454,17114,2017,9363,1484
"655","45073","Oconee County, South Carolina",31612,1579,26826,1783,21915,1819,2373,826,24453,1879,4911,1084,4786,1087
"656","45075","Orangeburg County, South Carolina",33561,1590,28506,1699,20318,1614,1284,438,27222,1735,8188,1461,5055,1032
"657","45077","Pickens County, South Carolina",48185,1643,42948,1988,34219,1950,1883,849,41065,2072,8729,1538,5237,1287
"658","45079","Richland County, South Carolina",152227,3083,143986,3259,120782,3872,4464,1088,139522,3401,23204,2445,8241,1291
"659","45083","Spartanburg County, South Carolina",116018,2117,103498,2795,83883,2974,5123,977,98375,2633,19615,2351,12520,1747
"660","45085","Sumter County, South Carolina",40396,1823,35352,2000,27418,2019,1244,479,34108,2005,7934,1491,5044,922
"661","45091","York County, South Carolina",100623,2060,94575,2232,81115,2755,3164,787,91411,2373,13460,2127,6048,1258
"662","46099","Minnehaha County, South Dakota",76630,1480,71368,1815,61581,2161,3170,684,68198,1885,9787,1564,5262,962
"663","46103","Pennington County, South Dakota",44794,1345,40973,1669,34189,1786,2801,676,38172,1677,6784,1394,3821,1012
"664","47001","Anderson County, Tennessee",29505,1575,26829,1625,20981,1708,1297,590,25532,1667,5848,1151,2676,935
"665","47009","Blount County, Tennessee",51446,1680,46314,1897,39276,1690,2554,782,43760,2043,7038,1428,5132,1101
"666","47011","Bradley County, Tennessee",39104,1543,34702,1791,27345,1952,1245,534,33457,1676,7357,1293,4402,1259
"667","47037","Davidson County, Tennessee",283445,3570,266714,4173,222329,5353,10281,1939,256433,4126,44385,3773,16731,2402
"668","47059","Greene County, Tennessee",27316,1451,23846,1644,17936,1790,1541,707,22305,1683,5910,1383,3470,956
"669","47065","Hamilton County, Tennessee",146057,2469,132588,3185,111722,3302,5627,1098,126961,3283,20866,2463,13469,1893
"670","47093","Knox County, Tennessee",185416,2418,170004,2780,143078,3236,6059,1099,163945,2758,26926,2687,15412,2097
"671","47113","Madison County, Tennessee",39223,1035,35486,1286,26731,1713,2382,915,33104,1312,8755,1471,3737,780
"672","47119","Maury County, Tennessee",34361,1393,31470,1586,26817,1533,1568,586,29902,1597,4653,1183,2891,847
"673","47125","Montgomery County, Tennessee",72973,2084,69879,2250,59885,2426,2317,761,67562,2462,9994,1530,3094,905
"674","47141","Putnam County, Tennessee",33388,867,30404,1283,24721,1838,1508,500,28896,1302,5683,1362,2984,1145
"675","47147","Robertson County, Tennessee",26375,792,24237,911,19453,1122,420,204,23817,942,4784,941,2138,558
"676","47149","Rutherford County, Tennessee",115376,2103,109975,2496,94810,3363,3593,1014,106382,2632,15165,2840,5401,1493
"677","47155","Sevier County, Tennessee",36861,1955,33051,2032,25427,2076,1473,707,31578,1872,7624,1531,3810,1050
"678","47157","Shelby County, Tennessee",352648,3767,299329,4637,229191,5533,10949,1635,288380,4728,70138,4838,53319,3941
"679","47163","Sullivan County, Tennessee",64504,1967,56805,2153,45744,2182,3612,896,53193,2123,11061,1398,7699,1257
"680","47165","Sumner County, Tennessee",68439,1460,63714,1638,52135,2052,2124,634,61590,1758,11579,1847,4725,944
"681","47179","Washington County, Tennessee",54433,2138,48983,2321,39057,2496,1928,683,47055,2305,9926,1711,5450,1232
"682","47187","Williamson County, Tennessee",80601,1433,78435,1691,75611,1886,1278,583,77157,1694,2824,878,2166,842
"683","47189","Wilson County, Tennessee",52489,1464,49222,1800,43070,1898,1628,636,47594,1732,6152,1248,3267,997
"684","48005","Angelina County, Texas",29898,1469,27305,1640,22762,1746,1454,538,25851,1639,4543,1107,2593,867
"685","48021","Bastrop County, Texas",25334,1456,22616,1566,17270,1696,800,356,21816,1575,5346,1290,2718,1056
"686","48027","Bell County, Texas",123188,2481,113934,2857,98380,3490,6315,1408,107619,3033,15554,2309,9254,1860
"687","48029","Bexar County, Texas",644193,4231,599824,5499,472098,7269,18953,1897,580871,5496,127726,6336,44369,3505
"688","48037","Bowie County, Texas",35228,1586,28762,1628,23046,1818,1375,569,27387,1659,5716,1361,6466,1363
"689","48039","Brazoria County, Texas",120802,2771,112721,3159,95788,3813,3279,857,109442,3088,16933,2827,8081,1897
"690","48041","Brazos County, Texas",81030,2472,77581,2521,68546,2923,2174,804,75407,2599,9035,1302,3449,978
"691","48061","Cameron County, Texas",124812,2810,103473,3264,69863,3394,3363,889,100110,3232,33610,2758,21339,1891
"692","48085","Collin County, Texas",344824,3891,339237,4018,316964,4742,7268,1120,331969,4245,22273,2717,5587,1267
"693","48091","Comal County, Texas",53182,1622,50023,1917,44123,2047,1681,712,48342,1941,5900,1332,3159,1144
"694","48099","Coryell County, Texas",21491,1410,19416,1476,15998,1658,1288,546,18128,1512,3418,908,2075,800
"695","48113","Dallas County, Texas",937438,5652,857816,6919,688900,8413,23665,2427,834151,7048,168916,5790,79622,5180
"696","48121","Denton County, Texas",297899,3021,291597,3414,265203,4173,5333,1300,286264,3613,26394,3024,6302,1520
"697","48135","Ector County, Texas",54326,1293,50290,1576,35073,2492,1642,606,48648,1701,15217,2567,4036,932
"698","48139","Ellis County, Texas",58633,1424,56550,1534,47502,2203,1192,426,55358,1598,9048,1440,2083,645
"699","48141","El Paso County, Texas",270160,3749,242853,4349,185370,4044,6123,1023,236730,4391,57483,3725,27307,1992
"700","48157","Fort Bend County, Texas",245410,3404,238410,3758,221399,4473,4008,939,234402,3987,17011,2560,7000,1664
"701","48167","Galveston County, Texas",121976,2780,113916,3027,95023,3591,2655,840,111261,3315,18893,2698,8060,1506
"702","48181","Grayson County, Texas",48963,1573,45238,1737,35024,2220,1697,570,43541,1742,10214,1736,3725,1024
"703","48183","Gregg County, Texas",45513,1787,41130,1895,29325,2157,1546,512,39584,2110,11805,2060,4383,998
"704","48187","Guadalupe County, Texas",54789,1319,51249,1488,43692,2106,1801,558,49448,1450,7557,1443,3540,937
"705","48201","Harris County, Texas",1600357,7642,1494324,9124,1202852,10318,37706,3504,1456618,9349,291472,9532,106033,5608
"706","48203","Harrison County, Texas",22928,1449,19904,1669,15950,1807,1223,585,18681,1578,3954,1094,3024,958
"707","48209","Hays County, Texas",75164,1856,72177,2209,62736,2808,1658,713,70519,2141,9441,2191,2987,1141
"708","48213","Henderson County, Texas",30843,1659,26604,1846,19440,1780,1287,504,25317,1855,7164,1488,4239,1288
"709","48215","Hidalgo County, Texas",237323,3787,199322,5080,131925,4938,6210,1375,193112,5247,67397,4410,38001,3591
"710","48231","Hunt County, Texas",34132,1031,31608,1196,24588,1375,1254,536,30354,1372,7020,1110,2524,665
"711","48245","Jefferson County, Texas",90839,2297,81520,2490,56896,2764,2692,848,78828,2536,24624,2340,9319,1457
"712","48251","Johnson County, Texas",59180,1324,55953,1484,45869,2104,1500,527,54453,1485,10084,1796,3227,1022
"713","48257","Kaufman County, Texas",39049,1186,35515,1436,28832,1506,860,480,34655,1568,6683,1333,3534,947
"714","48291","Liberty County, Texas",27468,1487,23281,1904,16971,1690,1117,544,22164,1963,6310,1730,4187,1236
"715","48303","Lubbock County, Texas",115686,2429,107416,2814,84970,3180,1983,564,105433,2778,22446,2672,8270,1620
"716","48309","McLennan County, Texas",92158,1849,81549,2597,64373,2725,2683,737,78866,2665,17176,2108,10609,1830
"717","48329","Midland County, Texas",57636,1380,54356,1829,43756,2618,863,481,53493,1888,10600,2101,3280,1196
"718","48339","Montgomery County, Texas",202797,3699,195652,3946,168316,4685,5724,1539,189928,4074,27336,3555,7145,1614
"719","48347","Nacogdoches County, Texas",23442,1439,20500,1693,15879,1768,506,247,19994,1675,4621,1259,2942,866
"720","48355","Nueces County, Texas",129987,2590,116753,3108,78632,2815,3577,897,113176,3027,38121,3134,13234,1838
"721","48361","Orange County, Texas",30047,1564,26975,1740,20459,1868,877,463,26098,1806,6516,1332,3072,784
"722","48367","Parker County, Texas",46238,1403,43889,1690,37789,1898,875,501,43014,1743,6100,1364,2349,891
"723","48375","Potter County, Texas",45550,1413,40998,1613,27916,1927,1318,493,39680,1644,13082,1783,4552,1032
"724","48381","Randall County, Texas",49457,1304,47611,1421,40817,1718,1613,500,45998,1558,6794,1336,1846,646
"725","48397","Rockwall County, Texas",34590,955,33925,1039,30684,1715,563,418,33362,976,3241,1497,665,458
"726","48409","San Patricio County, Texas",22202,1518,19129,1534,14026,1259,723,307,18406,1484,5103,987,3073,692
"727","48423","Smith County, Texas",77330,2129,72904,2332,46769,2883,2164,511,70740,2328,26135,2812,4426,1154
"728","48439","Tarrant County, Texas",722473,5537,693257,6434,571675,8319,18132,2320,675125,6870,121582,6204,29216,2659
"729","48441","Taylor County, Texas",49811,1537,45743,1652,36023,1838,1780,576,43963,1703,9720,1485,4068,940
"730","48451","Tom Green County, Texas",43301,1736,39763,2003,30288,2163,1000,368,38763,2054,9475,1669,3538,844
"731","48453","Travis County, Texas",486548,5582,471154,5937,419203,7205,10219,1651,460935,5814,51951,4108,15394,2308
"732","48469","Victoria County, Texas",31918,1297,27337,1671,19070,1680,1092,386,26245,1703,8267,1271,4581,1056
"733","48471","Walker County, Texas",22693,1371,20669,1556,17393,1621,817,494,19852,1572,3276,1130,2024,920
"734","48479","Webb County, Texas",75300,1538,64670,1905,45483,2189,1776,806,62894,2023,19187,1858,10630,1545
"735","48485","Wichita County, Texas",46757,2038,42316,2037,33475,2192,1865,681,40451,1978,8841,1484,4441,919
"736","48491","Williamson County, Texas",185345,2360,180719,2579,166229,2862,4925,1234,175794,2721,14490,1880,4626,1006
"737","48497","Wise County, Texas",22864,782,21496,1017,17747,1071,721,388,20775,1094,3749,767,1368,670
"738","49005","Cache County, Utah",39224,1012,37929,1102,34167,1240,1039,426,36890,1121,3762,827,1295,576
"739","49011","Davis County, Utah",104462,1731,102241,1849,93327,2094,2924,756,99317,1832,8914,1668,2221,617
"740","49035","Salt Lake County, Utah",381831,2681,367385,3285,329542,5091,11534,1774,355851,3730,37843,3887,14446,1759
"741","49045","Tooele County, Utah",20411,841,19426,971,17224,1018,972,497,18454,1093,2202,855,985,472
"742","49049","Utah County, Utah",171117,1597,168065,1674,158189,2268,3187,709,164878,1659,9876,1535,3052,886
"743","49053","Washington County, Utah",59863,2283,57202,2403,51546,2616,3371,849,53831,2425,5656,1516,2661,958
"744","49057","Weber County, Utah",85615,1753,81465,1980,72054,2495,2474,629,78991,2079,9411,1643,4150,822
"745","50007","Chittenden County, Vermont",66095,1198,62458,1592,56920,1796,4225,879,58233,1718,5538,1298,3637,1082
"746","51003","Albemarle County, Virginia",41956,1269,39870,1585,35639,1690,2364,688,37506,1670,4231,1061,2086,820
"747","51013","Arlington County, Virginia",109940,1822,104636,2160,99733,2400,2135,734,102501,2227,4903,1015,5304,1288
"748","51015","Augusta County, Virginia",29783,1272,26307,1635,21291,1637,1134,509,25173,1680,5016,1339,3476,927
"749","51019","Bedford County, Virginia",31271,1286,28393,1255,24289,1250,1769,704,26624,1440,4104,1072,2878,782
"750","51041","Chesterfield County, Virginia",126748,1556,120585,2120,109136,2799,4969,1066,115616,2205,11449,1952,6163,1350
"751","51059","Fairfax County, Virginia",396628,2777,386510,3006,367359,3917,11367,1523,375143,3177,19151,2310,10118,1663
"752","51061","Fauquier County, Virginia",25134,818,24030,944,22051,1031,997,371,23033,1014,1979,629,1104,442
"753","51069","Frederick County, Virginia",31551,1173,28700,1402,26132,1502,1821,656,26879,1602,2568,704,2851,882
"754","51085","Hanover County, Virginia",39929,871,37442,1216,34459,1590,1800,554,35642,1288,2983,946,2487,773
"755","51087","Henrico County, Virginia",129408,2025,120960,2114,106228,2967,5279,1171,115681,2279,14732,1975,8448,994
"756","51095","James City County, Virginia",29849,1736,28792,1763,26858,1750,1310,539,27482,1724,1934,823,1057,515
"757","51107","Loudoun County, Virginia",133417,1079,130543,1302,124881,1813,2610,1088,127933,1568,5662,1635,2874,937
"758","51121","Montgomery County, Virginia",34585,1619,31920,1903,26700,1947,723,414,31197,1917,5220,1282,2665,842
"759","51153","Prince William County, Virginia",143861,1657,140592,1853,129329,2405,3778,762,136814,2000,11263,1485,3269,880
"760","51161","Roanoke County, Virginia",38061,1042,34723,1307,30140,1531,1935,602,32788,1369,4583,1099,3338,1066
"761","51165","Rockingham County, Virginia",31462,1026,27907,1098,23780,1336,2259,570,25648,1276,4127,879,3555,727
"762","51177","Spotsylvania County, Virginia",45223,1001,43649,1082,38968,1337,1847,478,41802,1246,4681,867,1574,592
"763","51179","Stafford County, Virginia",48418,923,47386,1028,43256,1387,812,411,46574,1107,4130,1119,1032,472
"764","51199","York County, Virginia",24996,1038,23411,1257,22309,1239,1058,418,22353,1333,1102,440,1585,682
"765","51510","Alexandria city, Virginia",71740,1543,67628,1683,61873,1720,1530,570,66098,1858,5755,1320,4112,1110
"766","51550","Chesapeake city, Virginia",86122,1667,81630,2063,72941,2487,3649,848,77981,1988,8689,1787,4492,1181
"767","51650","Hampton city, Virginia",54800,1457,49821,1726,43760,2223,2590,839,47231,1769,6061,1171,4979,1329
"768","51680","Lynchburg city, Virginia",28500,1191,25520,1445,20826,1637,1502,650,24018,1567,4694,1056,2980,814
"769","51700","Newport News city, Virginia",71291,1906,64875,2030,53922,2528,3938,1017,60937,2141,10953,1929,6416,1263
"770","51710","Norfolk city, Virginia",89338,1882,82739,1948,64156,2532,3256,736,79483,2170,18583,2239,6599,914
"771","51740","Portsmouth city, Virginia",34578,1559,31268,1744,22594,1817,1380,585,29888,1664,8674,1428,3310,803
"772","51760","Richmond city, Virginia",91359,1702,82121,2258,66402,2499,2697,699,79424,2307,15719,2312,9238,1388
"773","51770","Roanoke city, Virginia",41353,1515,34696,1784,26388,1874,921,382,33775,1756,8308,1493,6657,1379
"774","51800","Suffolk city, Virginia",34890,939,31615,1194,26118,1656,1485,470,30130,1230,5497,1264,3275,824
"775","51810","Virginia Beach city, Virginia",172183,2346,165042,2701,147362,2876,4382,892,160660,2788,17680,2510,7141,1471
"776","53005","Benton County, Washington",71921,1765,67784,1885,58161,2127,2659,850,65125,1960,9623,1617,4137,1165
"777","53007","Chelan County, Washington",31587,1405,29379,1653,24564,1808,1004,384,28375,1606,4815,1324,2208,813
"778","53009","Clallam County, Washington",33265,1090,29950,1473,26830,1516,3027,761,26923,1596,3120,861,3315,893
"779","53011","Clark County, Washington",178980,1642,170753,2075,154176,2585,7803,1417,162950,2451,16577,2143,8227,1371
"780","53015","Cowlitz County, Washington",43279,861,39444,1344,32011,1786,2378,871,37066,1580,7433,1558,3835,1039
"781","53021","Franklin County, Washington",27067,858,25754,985,19969,1435,308,251,25446,987,5785,1347,1313,534
"782","53025","Grant County, Washington",30806,1705,28090,1716,21115,1572,1495,554,26595,1782,6975,1174,2716,981
"783","53027","Grays Harbor County, Washington",27674,1615,25017,1646,19973,1483,2074,563,22943,1672,5044,1219,2657,749
"784","53029","Island County, Washington",34572,1556,32839,1570,30601,1613,1679,469,31160,1642,2238,769,1733,686
"785","53033","King County, Washington",897476,5960,861049,6515,788706,7531,27210,2784,833839,6705,72343,5258,36427,3167
"786","53035","Kitsap County, Washington",105411,1928,100844,2053,92899,2347,4382,887,96462,2208,7945,1550,4567,959
"787","53041","Lewis County, Washington",30327,1125,27838,1054,23890,1177,2073,467,25765,1074,3948,951,2489,631
"788","53045","Mason County, Washington",25864,1614,24049,1736,20518,1929,1520,607,22529,1699,3531,1026,1815,850
"789","53053","Pierce County, Washington",328519,3174,312005,3267,272101,4479,12092,1463,299913,3526,39904,3209,16514,1909
"790","53057","Skagit County, Washington",48474,1107,45616,1466,40274,1567,3018,632,42598,1532,5342,1137,2858,783
"791","53061","Snohomish County, Washington",300215,2038,290008,2504,259639,3884,11189,1574,278819,2697,30369,3133,10207,1420
"792","53063","Spokane County, Washington",206191,2700,192835,3278,168572,3522,8808,1259,184027,3347,24263,2228,13356,1902
"793","53067","Thurston County, Washington",110713,1699,103987,2039,93930,2735,5127,1012,98860,2290,10057,1783,6726,1416
"794","53073","Whatcom County, Washington",87080,2014,81642,2293,73180,2800,4502,1138,77140,2435,8462,1841,5438,1293
"795","53077","Yakima County, Washington",83320,1615,75971,2076,54422,2726,3487,908,72484,2083,21549,2294,7349,1365
"796","54003","Berkeley County, West Virginia",45800,1196,41923,1335,34796,1982,1790,715,40133,1378,7127,1666,3877,1035
"797","54011","Cabell County, West Virginia",38024,1475,33876,1564,22688,1619,2129,777,31747,1724,11188,1721,4148,922
"798","54033","Harrison County, West Virginia",26878,1056,23580,1152,17962,1315,1501,598,22079,1152,5618,933,3298,822
"799","54039","Kanawha County, West Virginia",78482,2049,69409,2476,47743,2487,4210,1131,65199,2733,21666,2482,9073,1309
"800","54061","Monongalia County, West Virginia",40603,1237,38391,1322,33641,1419,1666,584,36725,1450,4750,944,2212,672
"801","54081","Raleigh County, West Virginia",31169,1392,25671,1787,19381,1797,1813,716,23858,1742,6290,1337,5498,1442
"802","54107","Wood County, West Virginia",36064,1022,31406,1408,24791,1659,1524,499,29882,1377,6615,1357,4658,940
"803","55009","Brown County, Wisconsin",104470,1568,95538,1987,81613,2375,5635,1093,89903,1944,13925,1847,8932,1371
"804","55025","Dane County, Wisconsin",226350,2321,215750,2749,197655,3661,10102,1254,205648,2696,18095,2527,10600,1542
"805","55027","Dodge County, Wisconsin",35221,877,31602,890,26427,1113,1800,437,29802,955,5175,900,3619,654
"806","55035","Eau Claire County, Wisconsin",40421,1246,37594,1421,33773,1524,2171,735,35423,1571,3821,904,2827,763
"807","55039","Fond du Lac County, Wisconsin",41009,1123,35818,1670,31417,1573,2666,725,33152,1654,4401,882,5191,980
"808","55055","Jefferson County, Wisconsin",33180,1004,30745,1115,26821,1159,1728,503,29017,1147,3924,815,2435,661
"809","55059","Kenosha County, Wisconsin",62950,1668,58007,1771,48291,1977,2458,632,55549,1782,9716,1717,4943,837
"810","55063","La Crosse County, Wisconsin",47924,958,43985,1315,38929,1418,2721,632,41264,1340,5056,1016,3939,974
"811","55071","Manitowoc County, Wisconsin",35259,747,31284,871,26639,1070,2714,651,28570,976,4645,814,3975,608
"812","55073","Marathon County, Wisconsin",56245,1115,50454,1423,43882,1377,3448,776,47006,1550,6572,1134,5791,989
"813","55079","Milwaukee County, Wisconsin",384281,3000,335706,3948,271393,4637,16975,1714,318731,4118,64313,3414,48575,3113
"814","55087","Outagamie County, Wisconsin",74603,1062,69102,1421,59567,1640,3505,747,65597,1614,9535,1495,5501,1014
"815","55089","Ozaukee County, Wisconsin",36261,897,33801,1031,31788,1265,2017,654,31784,1094,2013,721,2460,694
"816","55097","Portage County, Wisconsin",29193,567,26564,912,22325,1057,1892,461,24672,1046,4239,814,2629,768
"817","55101","Racine County, Wisconsin",76808,1706,70954,2027,59461,1937,4012,823,66942,1982,11493,1533,5854,980
"818","55105","Rock County, Wisconsin",64632,1246,58315,1716,48926,1859,3408,815,54907,1794,9389,1251,6317,1161
"819","55109","St. Croix County, Wisconsin",34422,895,31835,1306,27611,1329,1628,606,30207,1330,4224,800,2587,922
"820","55117","Sheboygan County, Wisconsin",46308,1297,41881,1432,36315,1613,2497,601,39384,1583,5566,1044,4427,868
"821","55127","Walworth County, Wisconsin",40864,1419,37644,1627,33142,1670,2005,545,35639,1695,4502,997,3220,938
"822","55131","Washington County, Wisconsin",55488,825,51865,1042,47356,1441,3352,740,48513,1150,4509,971,3623,807
"823","55133","Waukesha County, Wisconsin",158368,1823,149379,2064,137302,2476,8903,1249,140476,2236,12077,1737,8989,1281
"824","55139","Winnebago County, Wisconsin",71332,1395,65375,1601,54610,2187,3827,828,61548,1618,10765,1790,5957,998
"825","55141","Wood County, Wisconsin",32274,955,28624,1397,24435,1511,2322,658,26302,1304,4189,831,3650,815
"826","56021","Laramie County, Wyoming",39678,1342,36384,1611,32331,1689,1363,507,35021,1671,4053,1106,3294,951
"827","56025","Natrona County, Wyoming",32240,1234,30362,1247,25787,1506,2136,794,28226,1385,4575,1084,1878,556
"828","72013","Arecibo Municipio, Puerto Rico",30206,1651,21164,1742,12074,1458,719,377,20445,1772,9090,1330,9042,1171
"829","72021","Bayamón Municipio, Puerto Rico",64932,1973,56009,2070,33470,2077,2135,531,53874,2091,22539,1936,8923,1240
"830","72025","Caguas Municipio, Puerto Rico",47374,1611,37853,1831,24203,1769,1742,640,36111,1882,13650,1574,9521,1237
"831","72031","Carolina Municipio, Puerto Rico",61313,2117,50048,2169,30570,2380,2189,750,47859,2217,19478,2132,11265,1449
"832","72061","Guaynabo Municipio, Puerto Rico",27857,1698,23102,1702,15239,1663,535,247,22567,1699,7863,1283,4755,892
"833","72097","Mayagüez Municipio, Puerto Rico",30909,1411,24805,1601,12988,1413,865,386,23940,1681,11817,1423,6104,906
"834","72113","Ponce Municipio, Puerto Rico",53450,1675,36068,1874,25939,1942,4203,877,31865,1902,10129,1090,17382,1471
"835","72127","San Juan Municipio, Puerto Rico",147267,3135,91339,3331,61138,3097,6683,1261,84656,3344,30201,2639,55928,3046
"836","72135","Toa Alta Municipio, Puerto Rico",21511,1424,18109,1338,9721,1233,380,276,17729,1311,8388,1155,3402,817
"837","72137","Toa Baja Municipio, Puerto Rico",26085,1644,22944,1739,12758,1451,383,229,22561,1691,10186,1216,3141,679
"838","72139","Trujillo Alto Municipio, Puerto Rico",23195,1373,19110,1463,12273,1620,581,333,18529,1506,6837,1228,4085,844
