"","GEOID","NAME","B28010_001E","B28010_001M","B28010_002E","B28010_002M","B28010_003E","B28010_003M","B28010_004E","B28010_004M","B28010_005E","B28010_005M","B28010_006E","B28010_006M","B28010_007E","B28010_007M"
"1","01003","Baldwin County, Alabama",94105,3462,90474,3652,74753,4233,1837,690,88637,3675,15721,2787,3631,1139
"2","01015","Calhoun County, Alabama",44631,1889,42104,1975,30132,2077,978,607,41126,2064,11972,1734,2527,743
"3","01043","Cullman County, Alabama",35131,1361,33064,1500,24165,1500,1044,551,32020,1530,8899,1479,2067,682
"4","01049","DeKalb County, Alabama",24979,1117,22002,1437,14046,1361,1146,547,20856,1482,7956,1381,2977,952
"5","01051","Elmore County, Alabama",32108,1460,30497,1600,24888,1871,1367,648,29130,1580,5609,1417,1611,755
"6","01055","Etowah County, Alabama",38006,1724,34729,1748,24890,1640,965,408,33764,1730,9839,1287,3277,841
"7","01069","Houston County, Alabama",44058,937,41225,962,29815,1261,753,216,40472,1014,11410,979,2833,646
"8","01073","Jefferson County, Alabama",270147,3778,257364,4401,203337,5340,7888,1756,249476,4765,54027,3907,12783,1790
"9","01077","Lauderdale County, Alabama",38250,1562,35038,1726,25759,1878,1096,489,33942,1807,9279,1607,3212,828
"10","01081","Lee County, Alabama",67358,2031,64311,2392,55114,2715,2004,951,62307,2432,9197,2022,3047,1149
"11","01083","Limestone County, Alabama",40685,1358,36818,1864,31470,1895,957,639,35861,2053,5348,1425,3867,1371
"12","01089","Madison County, Alabama",164493,2228,158289,2481,142751,3091,3831,1165,154458,2537,15538,2767,6204,1703
"13","01095","Marshall County, Alabama",36003,1538,33032,1712,23862,1974,940,365,32092,1769,9170,1400,2971,869
"14","01097","Mobile County, Alabama",162963,2840,153725,2998,116340,3971,3781,1073,149944,3110,37385,3323,9238,1503
"15","01101","Montgomery County, Alabama",92407,2282,86776,2492,66270,2641,2597,855,84179,2663,20506,2349,5631,1080
"16","01103","Morgan County, Alabama",47558,1574,41093,2072,32620,2248,1361,628,39732,2126,8473,1477,6465,1547
"17","01115","St. Clair County, Alabama",33093,1559,31733,1606,27970,1741,871,453,30862,1715,3763,1065,1360,580
"18","01117","Shelby County, Alabama",86970,1334,84421,1551,74465,2377,999,454,83422,1583,9956,1993,2549,770
"19","01121","Talladega County, Alabama",33775,1243,31029,1375,20648,1921,1549,684,29480,1451,10381,1747,2746,1140
"20","01125","Tuscaloosa County, Alabama",86694,2669,81830,2801,65742,3073,1994,684,79836,2737,16088,2104,4864,1374
"21","02020","Anchorage Municipality, Alaska",109584,2068,106941,2197,94180,2711,2627,807,104314,2435,12761,2025,2643,977
"22","02090","Fairbanks North Star Borough, Alaska",36426,1589,35594,1618,29748,1802,1056,588,34538,1543,5846,1378,832,526
"23","02170","Matanuska-Susitna Borough, Alaska",40997,865,39672,950,33540,1028,1084,381,38588,993,6132,973,1325,460
"24","04001","Apache County, Arizona",19875,854,14236,959,11377,937,1260,506,12976,1009,2859,639,5639,648
"25","04003","Cochise County, Arizona",49952,1863,45786,1937,39045,2087,1796,492,43990,1973,6741,1385,4166,946
"26","04005","Coconino County, Arizona",55145,2173,52801,2231,45594,2377,812,472,51989,2270,7207,1495,2344,754
"27","04013","Maricopa County, Arizona",1708034,7178,1658846,7941,1477588,9604,42328,3083,1616518,7850,181258,8113,49188,4258
"28","04015","Mohave County, Arizona",102398,2250,96477,2886,78181,3995,4308,1233,92169,3377,18296,2634,5921,1739
"29","04017","Navajo County, Arizona",40087,1611,35748,1617,26602,1712,1026,498,34722,1603,9146,1556,4339,695
"30","04019","Pima County, Arizona",433148,4460,414636,4468,357292,5879,12703,1605,401933,4408,57344,4359,18512,2100
"31","04021","Pinal County, Arizona",155161,3396,149996,3589,128630,3990,3863,1239,146133,3711,21366,2469,5165,1155
"32","04025","Yavapai County, Arizona",112075,2177,107921,2410,93951,3376,4761,1374,103160,2391,13970,2912,4154,1108
"33","04027","Yuma County, Arizona",74981,2203,69911,2609,55191,2874,1531,597,68380,2693,14720,2114,5070,1452
"34","05007","Benton County, Arkansas",106553,2186,102900,2405,87868,2811,2052,790,100848,2427,15032,1893,3653,1047
"35","05031","Craighead County, Arkansas",42186,1618,39409,1731,31799,2495,905,431,38504,1716,7610,1887,2777,1032
"36","05045","Faulkner County, Arkansas",48497,1481,46719,1779,38492,2107,410,329,46309,1732,8227,1320,1778,780
"37","05051","Garland County, Arkansas",42077,2241,37931,2260,29630,2724,1421,613,36510,2246,8301,2010,4146,985
"38","05069","Jefferson County, Arkansas",24319,1118,22122,1274,15443,1397,869,421,21253,1279,6679,1319,2197,811
"39","05085","Lonoke County, Arkansas",27880,845,25948,926,20504,1334,419,270,25529,957,5444,1069,1932,650
"40","05119","Pulaski County, Arkansas",172100,2934,161955,3129,132081,3694,4047,1247,157908,3341,29874,3366,10145,1785
"41","05125","Saline County, Arkansas",49768,1107,48289,1417,38736,2107,496,319,47793,1414,9553,1895,1479,675
"42","05131","Sebastian County, Arkansas",51472,1829,47112,2061,35753,2717,811,411,46301,2022,11359,2042,4360,1413
"43","05143","Washington County, Arkansas",94220,1879,91654,2105,74595,3196,2007,735,89647,2108,17059,2728,2566,823
"44","05145","White County, Arkansas",29359,1310,27422,1519,20368,1887,534,341,26888,1553,7054,1511,1937,766
"45","06001","Alameda County, California",589180,4004,569865,4352,514535,5302,10670,1410,559195,4343,55330,4210,19315,2393
"46","06007","Butte County, California",81353,1910,78530,2087,68594,2584,2106,691,76424,2078,9936,1544,2823,783
"47","06013","Contra Costa County, California",411560,2396,400589,2787,363613,4032,7962,1198,392627,2818,36976,3500,10971,1856
"48","06017","El Dorado County, California",74909,2311,72025,2700,64103,2557,1650,649,70375,2855,7922,1701,2884,1108
"49","06019","Fresno County, California",322646,2438,300147,2765,245834,3955,6704,1244,293443,3178,54313,3527,22499,2158
"50","06023","Humboldt County, California",55184,1634,52816,1880,45900,2106,2208,747,50608,1980,6916,1479,2368,908
"51","06025","Imperial County, California",47849,1750,45376,1725,34242,2017,733,537,44643,1826,11134,1663,2473,699
"52","06029","Kern County, California",282963,3285,268295,3952,210286,5112,6342,1330,261953,4088,58009,3957,14668,1994
"53","06031","Kings County, California",43143,1116,40892,1333,32021,1463,430,323,40462,1363,8871,1423,2251,799
"54","06033","Lake County, California",27472,1368,25312,1455,20968,1781,1420,676,23892,1519,4344,1092,2160,893
"55","06037","Los Angeles County, California",3375587,11206,3249740,11999,2814604,13635,69440,4478,3180300,11950,435136,9520,125847,5190
"56","06039","Madera County, California",44048,1677,41779,1743,32134,2189,1163,636,40616,1892,9645,1696,2269,713
"57","06041","Marin County, California",103378,1853,100909,2016,93863,2412,3345,913,97564,2166,7046,1384,2469,994
"58","06045","Mendocino County, California",34273,1503,31355,1431,25569,1820,1065,420,30290,1384,5786,1285,2918,709
"59","06047","Merced County, California",84967,1569,77989,2206,61703,2913,1107,455,76882,2184,16286,2186,6978,1511
"60","06053","Monterey County, California",133224,1836,129858,2191,104877,2655,2804,908,127054,2388,24981,2699,3366,911
"61","06055","Napa County, California",49979,1257,48619,1313,43576,1403,1549,538,47070,1414,5043,1081,1360,548
"62","06057","Nevada County, California",42679,1994,41296,2100,37689,2187,1261,552,40035,2124,3607,1172,1383,673
"63","06059","Orange County, California",1077193,4687,1052249,5741,962349,7182,21671,2675,1030578,5931,89900,4888,24944,2699
"64","06061","Placer County, California",155945,1856,151941,2215,140532,2425,4467,863,147474,2255,11409,1454,4004,1118
"65","06065","Riverside County, California",765673,5559,738867,6333,646330,6675,20542,2271,718325,7088,92537,4887,26806,2932
"66","06067","Sacramento County, California",571949,3316,556774,3627,494678,5123,14558,2048,542216,4005,62096,4175,15175,2116
"67","06069","San Benito County, California",20307,353,19740,477,16222,875,251,218,19489,527,3518,882,567,282
"68","06071","San Bernardino County, California",675929,4311,654737,4943,561453,6963,15111,2083,639626,5427,93284,4685,21192,2770
"69","06073","San Diego County, California",1162896,5092,1131914,5341,1029442,6643,25354,2624,1106560,5506,102472,5060,30982,2831
"70","06075","San Francisco County, California",350796,5380,338659,5729,307005,6002,9331,1402,329328,5843,31654,2840,12137,1989
"71","06077","San Joaquin County, California",241760,2076,232319,2429,194579,2997,4881,1030,227438,2707,37740,3069,9441,1388
"72","06079","San Luis Obispo County, California",107571,2567,104102,2737,94125,2939,3387,975,100715,2662,9977,1773,3469,1015
"73","06081","San Mateo County, California",264135,2347,258069,2719,237387,3137,6043,1309,252026,2919,20682,2231,6066,1310
"74","06083","Santa Barbara County, California",150550,2185,144406,2598,128246,2877,4519,956,139887,2547,16160,1946,6144,1385
"75","06085","Santa Clara County, California",650593,3591,637246,4074,595456,5292,12274,1641,624972,4461,41790,3870,13347,2125
"76","06087","Santa Cruz County, California",97353,2136,94627,2405,84729,2827,3846,936,90781,2602,9898,1559,2726,1079
"77","06089","Shasta County, California",71506,1733,68489,1828,57728,1988,3888,973,64601,1883,10761,1726,3017,729
"78","06095","Solano County, California",157617,1748,152606,2170,134384,2939,4723,1195,147883,2409,18222,2237,5011,1270
"79","06097","Sonoma County, California",190586,2185,186421,2362,168778,3169,7288,1371,179133,2709,17643,2252,4165,804
"80","06099","Stanislaus County, California",174209,2086,166678,2554,133711,3838,3149,753,163529,2493,32967,3370,7531,1425
"81","06101","Sutter County, California",33655,658,32653,801,25834,1328,1659,718,30994,1040,6819,1203,1002,443
"82","06103","Tehama County, California",23950,1104,21743,1123,17396,1369,824,350,20919,1075,4347,1019,2207,783
"83","06107","Tulare County, California",143541,1614,134418,2195,106500,3074,3304,1071,131114,2340,27918,2553,9123,1557
"84","06111","Ventura County, California",279168,2760,270251,2986,239079,3773,7743,1134,262508,2903,31172,2753,8917,1580
"85","06113","Yolo County, California",76844,1623,74069,1746,66024,2308,1301,441,72768,1811,8045,1493,2775,896
"86","06115","Yuba County, California",27942,908,26506,1159,21747,1559,760,477,25746,1204,4759,1201,1436,645
"87","08001","Adams County, Colorado",183023,1658,176422,2199,153816,3515,4583,1134,171839,2504,22606,2975,6601,1521
"88","08005","Arapahoe County, Colorado",250041,2470,243741,2731,221394,3747,5727,1051,238014,2769,22347,2865,6300,1045
"89","08013","Boulder County, Colorado",135607,1819,133922,1907,126540,2156,3527,770,130395,2102,7382,1310,1685,534
"90","08014","Broomfield County, Colorado",30161,866,29709,847,28023,1027,912,376,28797,929,1686,660,452,259
"91","08031","Denver County, Colorado",326634,3286,317661,3562,283209,4870,6883,1477,310778,3862,34452,3478,8973,1744
"92","08035","Douglas County, Colorado",136238,1302,134625,1391,129307,1722,1305,543,133320,1518,5318,1226,1613,730
"93","08041","El Paso County, Colorado",282904,2926,277438,3149,253102,4003,5341,949,272097,3171,24336,2668,5466,1114
"94","08059","Jefferson County, Colorado",239823,1845,232964,2051,216313,2669,6217,1128,226747,2278,16651,2084,6859,1307
"95","08069","Larimer County, Colorado",152123,2052,148481,2504,138317,2816,4214,1032,144267,2649,10164,1765,3642,1175
"96","08077","Mesa County, Colorado",63796,1732,61565,1802,52813,2477,2459,727,59106,1858,8752,1703,2231,905
"97","08101","Pueblo County, Colorado",69078,1103,65117,1414,53035,2120,3407,1073,61710,1683,12082,1900,3961,827
"98","08123","Weld County, Colorado",119502,1547,115769,1858,100286,2517,2889,934,112880,2195,15483,1916,3733,1064
"99","09001","Fairfield County, Connecticut",357271,2972,341664,3258,305803,4444,10701,1553,330963,3298,35861,3075,15607,2145
"100","09003","Hartford County, Connecticut",360140,3030,342692,3793,297680,4909,11033,1493,331659,4029,45012,3155,17448,1819
"101","09005","Litchfield County, Connecticut",77106,1655,72980,1828,65681,2021,3274,809,69706,1944,7299,1664,4126,895
"102","09007","Middlesex County, Connecticut",69789,1705,67165,1859,59727,2388,1866,741,65299,1872,7438,1432,2624,715
"103","09009","New Haven County, Connecticut",349089,3295,330960,3987,278177,4965,12141,1819,318819,4300,52783,4288,18129,2220
"104","09011","New London County, Connecticut",110950,1778,105576,2045,93019,2627,4751,968,100825,2120,12557,1770,5374,1303
"105","09013","Tolland County, Connecticut",58244,1449,56673,1548,51445,1934,1881,573,54792,1645,5228,1193,1571,739
"106","09015","Windham County, Connecticut",45724,1492,43073,1655,35286,2122,1972,837,41101,1638,7787,1608,2651,710
"107","10001","Kent County, Delaware",70167,1212,67115,1294,57375,1890,2571,841,64544,1516,9740,1810,3052,902
"108","10003","New Castle County, Delaware",220758,2202,212085,2522,184866,4267,6559,1226,205526,2770,27219,3415,8673,1435
"109","10005","Sussex County, Delaware",104731,2939,100339,3080,86998,2978,3318,947,97021,3364,13341,1857,4392,880
"110","11001","District of Columbia, District of Columbia",319565,3541,308014,4137,267764,5337,6110,1364,301904,4424,40250,3686,11551,2141
"111","12001","Alachua County, Florida",108189,2517,104982,2842,92590,3244,2888,899,102094,3034,12392,2124,3207,1057
"112","12005","Bay County, Florida",79532,2918,76769,2936,64160,2890,2785,865,73984,2929,12609,2248,2763,862
"113","12009","Brevard County, Florida",254314,3783,245271,4172,213531,4519,9610,1507,235661,4052,31740,3177,9043,1610
"114","12011","Broward County, Florida",747715,6267,721395,6954,636633,7718,16557,2341,704838,7240,84762,4776,26320,3213
"115","12015","Charlotte County, Florida",88988,3205,86087,3316,72060,3483,3608,969,82479,3358,14027,2501,2901,1038
"116","12017","Citrus County, Florida",68269,2333,63955,2256,53000,2598,3857,923,60098,2353,10955,2039,4314,1324
"117","12019","Clay County, Florida",80459,2040,78774,2167,68772,2834,2319,839,76455,2342,10002,2083,1685,828
"118","12021","Collier County, Florida",163943,4893,159096,4754,136092,5637,4803,1268,154293,4686,23004,3052,4847,1396
"119","12023","Columbia County, Florida",27545,1092,26168,1381,21295,1595,1205,585,24963,1399,4873,1148,1377,702
"120","12031","Duval County, Florida",406301,5163,389571,5959,333305,6588,9573,1918,379998,6055,56266,4379,16730,2600
"121","12033","Escambia County, Florida",126980,2622,120704,2762,98161,3387,3684,914,117020,2871,22543,2503,6276,1232
"122","12035","Flagler County, Florida",48187,1799,46150,2023,38638,2125,1866,597,44284,1971,7512,1417,2037,856
"123","12053","Hernando County, Florida",81497,1957,78072,2201,67202,2498,3822,942,74250,2277,10870,1860,3425,950
"124","12055","Highlands County, Florida",46166,2249,42729,2336,33459,2432,2577,781,40152,2427,9270,1791,3437,1295
"125","12057","Hillsborough County, Florida",578259,4604,561365,4786,491503,5861,12197,1613,549168,4848,69862,4965,16894,1968
"126","12061","Indian River County, Florida",69974,2297,66231,2390,56159,2394,2694,699,63537,2344,10072,1891,3743,1352
"127","12069","Lake County, Florida",156435,3639,148805,4075,116185,5609,4928,1167,143877,4049,32620,4198,7630,2288
"128","12071","Lee County, Florida",320466,5688,310501,5253,265347,6436,10593,1551,299908,5240,45154,3625,9965,1888
"129","12073","Leon County, Florida",121423,2483,118425,2754,104514,3103,2086,633,116339,2897,13911,2290,2998,967
"130","12081","Manatee County, Florida",163520,4229,157841,4376,138650,3899,5526,1293,152315,4395,19191,2835,5679,1219
"131","12083","Marion County, Florida",157348,3156,148972,3831,125282,4593,6728,1674,142244,3961,23690,3326,8376,1925
"132","12085","Martin County, Florida",69719,2201,67736,2227,57630,2583,3178,989,64558,2404,10106,1843,1983,841
"133","12086","Miami-Dade County, Florida",963477,6902,929063,6798,771068,9368,16712,2231,912351,7402,157995,7370,34414,3479
"134","12087","Monroe County, Florida",36078,1787,34552,1784,30239,1711,1262,549,33290,1938,4313,1084,1526,680
"135","12089","Nassau County, Florida",40276,1134,39628,1292,34482,1765,1084,582,38544,1285,5146,1379,648,425
"136","12091","Okaloosa County, Florida",84497,2515,81020,2800,69690,2995,2114,668,78906,2869,11330,2198,3477,1024
"137","12095","Orange County, Florida",512496,6481,499945,7226,424158,8469,8391,1675,491554,7355,75787,5736,12551,2363
"138","12097","Osceola County, Florida",133330,4151,129395,4416,108995,4714,1868,735,127527,4400,20400,3431,3935,1541
"139","12099","Palm Beach County, Florida",595447,7364,572394,7401,492513,7615,17824,2295,554570,7615,79881,5396,23053,2599
"140","12101","Pasco County, Florida",230060,3739,219077,4142,189291,4646,9024,1383,210053,4212,29786,2820,10983,2065
"141","12103","Pinellas County, Florida",419798,5705,401883,5877,345020,6442,16186,1806,385697,6121,56863,4389,17915,2363
"142","12105","Polk County, Florida",276469,4275,264810,4713,207840,5455,7830,1340,256980,4821,56970,4782,11659,2129
"143","12107","Putnam County, Florida",29765,1450,26786,1544,19707,1573,726,351,26060,1545,7079,1395,2979,824
"144","12109","St. Johns County, Florida",109147,2862,104152,3230,96017,3627,2274,921,101878,3297,8135,1715,4995,1538
"145","12111","St. Lucie County, Florida",131235,4867,126709,4970,107776,5840,4507,1305,122202,4865,18933,3192,4526,1215
"146","12113","Santa Rosa County, Florida",71722,2129,69584,2424,62214,2811,2453,797,67131,2346,7370,1668,2138,875
"147","12115","Sarasota County, Florida",204018,4799,194655,5271,169401,5545,7362,1307,187293,5041,25254,3225,9363,1725
"148","12117","Seminole County, Florida",188239,1849,184610,1943,157804,3467,4016,1081,180594,2199,26806,3357,3629,948
"149","12119","Sumter County, Florida",68792,2697,66552,2753,56304,2772,3734,1544,62818,3153,10248,2192,2240,907
"150","12127","Volusia County, Florida",243344,3599,232316,3898,194545,4902,9232,1597,223084,3929,37771,3628,11028,2024
"151","12131","Walton County, Florida",33941,3149,33118,3205,28177,2907,1436,1003,31682,3032,4941,1433,823,607
"152","13013","Barrow County, Georgia",30194,457,29343,638,25228,1195,837,347,28506,693,4115,1090,851,416
"153","13015","Bartow County, Georgia",38903,1482,36393,1695,31017,1837,404,423,35989,1708,5376,1315,2510,1019
"154","13021","Bibb County, Georgia",57677,2209,53489,2378,41751,2577,1487,608,52002,2409,11738,2029,4188,1122
"155","13031","Bulloch County, Georgia",29318,2563,27570,2797,23964,2725,901,511,26669,2810,3606,1009,1748,810
"156","13045","Carroll County, Georgia",43859,1293,42367,1345,33709,2154,1038,514,41329,1469,8658,1728,1492,468
"157","13047","Catoosa County, Georgia",26864,825,25242,1066,21523,1516,378,315,24864,1087,3719,1274,1622,793
"158","13051","Chatham County, Georgia",121028,2329,115315,2807,100018,3198,2588,1241,112727,2968,15297,2615,5713,1630
"159","13057","Cherokee County, Georgia",100023,1578,97447,1985,89218,2338,1789,850,95658,2239,8229,1682,2576,1117
"160","13059","Clarke County, Georgia",55332,1776,52748,2111,47373,2453,877,481,51871,2245,5375,1309,2584,1087
"161","13063","Clayton County, Georgia",106249,2018,104368,2314,86575,3252,3276,1283,101092,2409,17793,2889,1881,817
"162","13067","Cobb County, Georgia",292841,2799,287803,2936,263607,4511,4486,1023,283317,2979,24196,3543,5038,1169
"163","13073","Columbia County, Georgia",51178,2129,49302,2256,44047,2255,790,492,48512,2228,5255,1287,1876,1005
"164","13077","Coweta County, Georgia",55729,1197,54383,1115,50327,1624,1527,639,52856,1329,4056,1261,1346,492
"165","13089","DeKalb County, Georgia",273981,4722,264769,4960,238497,4841,8040,1737,256729,4970,26272,3075,9212,2153
"166","13095","Dougherty County, Georgia",34835,1359,31571,1442,22321,1833,1058,527,30513,1481,9250,1678,3264,914
"167","13097","Douglas County, Georgia",51441,1169,49405,1641,42625,2458,1140,583,48265,1775,6780,2059,2036,1075
"168","13103","Effingham County, Georgia",23373,837,22601,902,19350,1380,192,183,22409,962,3251,1267,772,442
"169","13113","Fayette County, Georgia",43689,1072,42591,1226,39015,1652,1537,799,41054,1492,3576,1248,1098,592
"170","13115","Floyd County, Georgia",35417,1313,33230,1412,25282,1597,904,427,32326,1438,7948,1598,2187,691
"171","13117","Forsyth County, Georgia",86475,1302,85830,1330,81503,1543,1486,529,84344,1388,4327,1049,645,326
"172","13121","Fulton County, Georgia",467735,4859,455284,5115,415142,6479,9172,1998,446112,5477,40142,4719,12451,2414
"173","13127","Glynn County, Georgia",34137,1841,32466,2019,25415,2641,943,544,31523,2043,7051,1697,1671,820
"174","13135","Gwinnett County, Georgia",323014,2652,318554,2958,290802,4402,5851,1154,312703,3181,27752,3283,4460,1482
"175","13139","Hall County, Georgia",72454,1662,68119,2136,57758,2220,1789,729,66330,2098,10361,1829,4335,1386
"176","13151","Henry County, Georgia",84978,1493,81754,2075,73014,2788,1347,651,80407,2131,8740,1970,3224,1263
"177","13153","Houston County, Georgia",60815,1799,58149,2218,49708,2660,1160,517,56989,2255,8441,2222,2666,1058
"178","13157","Jackson County, Georgia",25272,1409,24424,1364,20341,1636,429,328,23995,1364,4083,1160,848,523
"179","13179","Liberty County, Georgia",23883,1164,22784,1284,18364,1321,400,255,22384,1304,4420,1053,1099,515
"180","13185","Lowndes County, Georgia",45139,1469,43726,1563,33599,2274,611,382,43115,1566,10127,1814,1413,566
"181","13215","Muscogee County, Georgia",82663,2071,77693,2600,59581,3309,1559,544,76134,2636,18112,2808,4970,1305
"182","13217","Newton County, Georgia",41515,592,39850,1042,34785,1788,1791,871,38059,1346,5065,1756,1665,840
"183","13223","Paulding County, Georgia",58025,1692,57563,1772,52782,2247,1141,604,56422,1841,4781,1322,462,439
"184","13245","Richmond County, Georgia",74476,2795,70666,2991,53738,3249,2692,1141,67974,2964,16928,2335,3810,1147
"185","13247","Rockdale County, Georgia",33141,1169,31495,1459,26434,2011,1761,1200,29734,1751,5061,1533,1646,871
"186","13255","Spalding County, Georgia",25696,981,23043,1340,19034,1574,731,623,22312,1470,4009,1275,2653,1010
"187","13285","Troup County, Georgia",26768,982,24795,1120,19790,1525,674,423,24121,1212,5005,1194,1973,735
"188","13295","Walker County, Georgia",26315,1092,24764,1211,18844,1830,887,488,23877,1300,5920,1627,1551,653
"189","13297","Walton County, Georgia",35628,628,34058,920,29161,1433,957,453,33101,1086,4897,1149,1570,699
"190","13313","Whitfield County, Georgia",35746,1192,32820,1435,24603,1759,823,431,31997,1466,8217,1633,2926,1050
"191","15001","Hawaii County, Hawaii",72194,2449,67233,2595,56858,2667,2578,860,64655,2837,10375,1861,4961,1250
"192","15003","Honolulu County, Hawaii",338093,3369,324336,3914,286016,4626,8144,1248,316192,4108,38320,2768,13757,1933
"193","15007","Kauai County, Hawaii",23464,1153,22708,1245,19174,1252,489,418,22219,1245,3534,672,756,429
"194","15009","Maui County, Hawaii",56319,1832,53568,2129,47043,2176,1312,529,52256,2209,6525,1325,2751,888
"195","16001","Ada County, Idaho",196255,2415,190848,2647,180975,2977,5594,1583,185254,3015,9873,1876,5407,1538
"196","16005","Bannock County, Idaho",33557,890,31392,1047,27096,1385,460,291,30932,1104,4296,977,2165,727
"197","16019","Bonneville County, Idaho",42905,1169,41409,1397,35302,1641,987,399,40422,1444,6107,1326,1496,614
"198","16027","Canyon County, Idaho",82667,1276,78948,1772,66610,2428,2274,1014,76674,1803,12338,2015,3719,1220
"199","16055","Kootenai County, Idaho",67771,2325,65227,2620,55434,2876,2325,848,62902,2790,9793,2147,2544,893
"200","16083","Twin Falls County, Idaho",34311,945,32426,1224,25732,1951,472,299,31954,1272,6694,1768,1885,847
"201","17019","Champaign County, Illinois",84248,2037,81324,2362,72612,2551,1423,414,79901,2468,8712,1756,2924,957
"202","17031","Cook County, Illinois",2072143,8684,1968259,9554,1694078,10382,51970,3517,1916289,9901,274181,9007,103884,5872
"203","17037","DeKalb County, Illinois",38916,1154,37329,1295,32373,1807,1485,785,35844,1399,4956,1188,1587,576
"204","17043","DuPage County, Illinois",350639,2421,341465,2886,311470,3717,8660,1494,332805,3044,29995,2532,9174,1427
"205","17089","Kane County, Illinois",183427,1916,177050,2643,160015,3110,3756,1036,173294,2585,17035,2292,6377,1685
"206","17091","Kankakee County, Illinois",41020,1343,38798,1463,31021,1590,1154,600,37644,1517,7777,1423,2222,791
"207","17093","Kendall County, Illinois",44208,1313,43764,1295,37155,2357,336,217,43428,1325,6609,2077,444,285
"208","17097","Lake County, Illinois",254744,2462,246459,2678,219609,3296,5684,1099,240775,2898,26850,2722,8285,1318
"209","17099","LaSalle County, Illinois",44972,1348,41659,1590,33498,1901,989,360,40670,1662,8161,1347,3313,851
"210","17111","McHenry County, Illinois",116768,1172,114089,1297,101451,2299,3410,854,110679,1479,12638,2077,2679,787
"211","17113","McLean County, Illinois",69263,1481,66811,1761,58993,2316,1726,572,65085,1710,7818,1556,2452,884
"212","17115","Macon County, Illinois",43914,1181,40770,1391,31316,1535,1654,620,39116,1497,9454,1291,3144,841
"213","17119","Madison County, Illinois",109818,1839,102797,2070,86688,2334,3761,823,99036,2252,16109,1861,7021,1308
"214","17143","Peoria County, Illinois",79307,1430,76083,1752,62494,2530,2240,618,73843,1945,13589,1961,3224,972
"215","17161","Rock Island County, Illinois",60187,1464,56191,1630,45642,2057,1840,603,54351,1715,10549,1482,3996,1052
"216","17163","St. Clair County, Illinois",98926,2449,93649,2536,79530,2770,2824,704,90825,2746,14119,2128,5277,1144
"217","17167","Sangamon County, Illinois",84414,1678,79533,1951,64398,2423,2657,649,76876,2012,15135,2222,4881,1188
"218","17179","Tazewell County, Illinois",55208,1183,51685,1360,42985,1797,1872,595,49813,1377,8700,1312,3523,949
"219","17183","Vermilion County, Illinois",29007,1260,25580,1251,17571,1415,883,317,24697,1324,8009,1183,3427,761
"220","17197","Will County, Illinois",242530,1783,234887,2016,208237,3195,5967,884,228920,2061,26650,2592,7643,1300
"221","17199","Williamson County, Illinois",27361,1282,24682,1405,19450,1739,886,440,23796,1446,5232,1104,2679,915
"222","17201","Winnebago County, Illinois",115282,1861,107781,2242,87760,2637,3974,851,103807,2403,20021,2273,7501,1291
"223","18003","Allen County, Indiana",154866,1665,148361,2015,122350,2508,3901,899,144460,1961,26011,2166,6505,1340
"224","18005","Bartholomew County, Indiana",32518,999,30975,1109,25662,1571,1040,411,29935,1249,5313,1245,1543,457
"225","18011","Boone County, Indiana",28048,644,27366,672,24287,1133,398,238,26968,691,3079,987,682,383
"226","18019","Clark County, Indiana",50153,1093,47869,1429,38484,1831,1760,608,46109,1552,9385,1732,2284,850
"227","18035","Delaware County, Indiana",45977,1583,43680,1701,35321,1819,1697,553,41983,1830,8359,1409,2297,678
"228","18039","Elkhart County, Indiana",69015,2038,63919,2302,49315,2880,1689,701,62230,2385,14604,2115,5096,1198
"229","18043","Floyd County, Indiana",30846,1223,28960,1272,24512,1372,822,379,28138,1263,4448,886,1886,507
"230","18053","Grant County, Indiana",26342,1115,24582,1127,18440,1296,1016,459,23566,1219,6142,1279,1760,579
"231","18057","Hamilton County, Indiana",132255,2110,130263,2272,123302,2387,2722,1169,127541,2775,6961,1516,1992,855
"232","18059","Hancock County, Indiana",32661,428,31621,694,27795,1206,643,515,30978,879,3826,1145,1040,621
"233","18063","Hendricks County, Indiana",65751,1304,63832,1782,56479,2485,1495,723,62337,1911,7353,1846,1919,950
"234","18067","Howard County, Indiana",36530,1135,34240,1311,26283,1679,1175,494,33065,1334,7957,1329,2290,725
"235","18081","Johnson County, Indiana",62116,1061,59883,1274,53557,1845,1582,636,58301,1399,6326,1534,2233,913
"236","18085","Kosciusko County, Indiana",31523,1326,29637,1516,23869,1719,1362,498,28275,1630,5768,1280,1886,573
"237","18089","Lake County, Indiana",192256,2438,179410,2943,146179,3534,8334,1465,171076,3165,33231,3260,12846,1752
"238","18091","LaPorte County, Indiana",43445,1247,40871,1450,31802,1678,1738,542,39133,1438,9069,1388,2574,803
"239","18095","Madison County, Indiana",53910,1249,50736,1457,39492,2038,2110,614,48626,1547,11244,1476,3174,779
"240","18097","Marion County, Indiana",394717,3891,377837,4278,311300,5889,10388,1497,367449,4320,66537,4760,16880,2489
"241","18105","Monroe County, Indiana",56714,2202,54627,2277,47164,2556,1123,522,53504,2256,7463,1464,2087,640
"242","18109","Morgan County, Indiana",26821,1170,24571,1131,20903,1296,1113,546,23458,1229,3668,918,2250,759
"243","18127","Porter County, Indiana",68266,1116,65393,1315,56436,1862,926,404,64467,1344,8957,1384,2873,862
"244","18141","St. Joseph County, Indiana",107076,1965,100724,2223,83485,2516,2941,884,97783,2234,17239,1802,6352,1128
"245","18157","Tippecanoe County, Indiana",73525,1680,71815,1715,52193,2946,1795,663,70020,1808,19622,2991,1710,549
"246","18163","Vanderburgh County, Indiana",79215,1478,73868,1827,56004,2873,1687,574,72181,1775,17864,2476,5347,1061
"247","18167","Vigo County, Indiana",42140,1331,39843,1412,31715,1660,1037,598,38806,1471,8128,1278,2297,487
"248","18177","Wayne County, Indiana",26452,1416,24462,1399,18639,1659,830,303,23632,1396,5823,1098,1990,601
"249","19013","Black Hawk County, Iowa",53951,1327,50462,1689,40020,2046,2201,609,48261,1656,10442,1809,3489,958
"250","19049","Dallas County, Iowa",41681,502,40478,772,36741,1206,569,332,39909,829,3737,987,1203,558
"251","19061","Dubuque County, Iowa",40482,984,38350,1055,33321,1238,1125,332,37225,1120,5029,894,2132,643
"252","19103","Johnson County, Iowa",61301,1982,59419,2121,53347,2541,1344,708,58075,2198,6072,1407,1882,829
"253","19113","Linn County, Iowa",94884,1538,90772,1858,80227,2393,1914,664,88858,1945,10545,1695,4112,961
"254","19153","Polk County, Iowa",203390,2491,195926,2859,168272,3808,5229,1180,190697,2925,27654,3043,7464,1272
"255","19155","Pottawattamie County, Iowa",37930,822,35114,1124,28782,1435,1418,552,33696,1141,6332,1128,2816,661
"256","19163","Scott County, Iowa",72128,1439,67688,1696,57650,2143,2257,813,65431,1921,10038,1694,4440,1030
"257","19169","Story County, Iowa",38868,1058,37700,1097,34950,1348,856,409,36844,1208,2750,988,1168,441
"258","19193","Woodbury County, Iowa",41327,955,39250,1102,30920,1837,1215,441,38035,1192,8330,1707,2077,497
"259","20015","Butler County, Kansas",24545,1212,23253,1232,19030,1397,654,335,22599,1265,4223,1086,1292,490
"260","20045","Douglas County, Kansas",49759,1419,48075,1501,42291,2013,1021,448,47054,1552,5784,1739,1684,644
"261","20091","Johnson County, Kansas",245646,2000,240868,2405,222222,3228,5178,1067,235690,2663,18646,2315,4778,1161
"262","20103","Leavenworth County, Kansas",29963,889,28803,1026,25214,1312,722,319,28081,1064,3589,1087,1160,578
"263","20161","Riley County, Kansas",27866,1133,27149,1202,25053,1521,846,456,26303,1353,2096,860,717,507
"264","20173","Sedgwick County, Kansas",203656,2831,196990,2995,160792,3674,7043,1230,189947,3000,36198,2603,6666,1145
"265","20177","Shawnee County, Kansas",74908,1521,69199,1814,57608,1895,1755,560,67444,1802,11591,1615,5709,1137
"266","20209","Wyandotte County, Kansas",62538,1197,58177,1522,44152,2008,1833,562,56344,1560,14025,1588,4361,996
"267","21015","Boone County, Kentucky",50728,873,47446,1247,43383,1447,1591,629,45855,1443,4063,1230,3282,1005
"268","21029","Bullitt County, Kentucky",30979,1033,28998,1251,23979,1410,695,318,28303,1228,5019,1067,1981,671
"269","21037","Campbell County, Kentucky",39048,934,36984,1106,32805,1341,1325,580,35659,1211,4179,907,2064,620
"270","21047","Christian County, Kentucky",25317,1182,22914,1225,18440,1321,661,424,22253,1294,4474,950,2403,801
"271","21059","Daviess County, Kentucky",41246,1104,38895,1366,30893,1639,1617,566,37278,1420,8002,1346,2351,919
"272","21067","Fayette County, Kentucky",139303,1880,134421,2113,114930,2692,1946,566,132475,2184,19491,2654,4882,1141
"273","21093","Hardin County, Kentucky",42714,1264,40483,1590,33515,1831,1397,512,39086,1615,6968,1485,2231,885
"274","21111","Jefferson County, Kentucky",331104,3391,312751,4117,256651,4722,9016,1488,303735,4110,56100,3778,18353,2632
"275","21117","Kenton County, Kentucky",68073,1360,65174,1538,54724,1948,2504,943,62670,1625,10450,1981,2899,909
"276","21145","McCracken County, Kentucky",25531,1374,24597,1537,20580,1738,734,394,23863,1476,4017,1109,934,579
"277","21151","Madison County, Kentucky",36052,1241,33543,1380,26533,1798,1024,518,32519,1412,7010,1548,2509,816
"278","21185","Oldham County, Kentucky",22895,545,22365,686,20031,821,445,274,21920,661,2334,718,530,381
"279","21199","Pulaski County, Kentucky",25509,1392,22144,1525,16844,1578,676,549,21468,1516,5300,1321,3365,948
"280","21227","Warren County, Kentucky",53093,1654,50725,1761,40718,2402,733,351,49992,1786,10007,1958,2368,828
"281","22005","Ascension Parish, Louisiana",48129,1199,46741,1264,37623,2173,720,424,46021,1249,9118,2215,1388,671
"282","22015","Bossier Parish, Louisiana",49418,1677,46681,1856,37956,2221,1290,641,45391,1990,8725,1658,2737,923
"283","22017","Caddo Parish, Louisiana",96369,2442,88048,2768,63585,3311,3146,1162,84902,2856,24463,2930,8321,1745
"284","22019","Calcasieu Parish, Louisiana",71511,3000,66357,3163,50924,3439,2328,1167,64029,3242,15433,2614,5154,1441
"285","22033","East Baton Rouge Parish, Louisiana",175731,3797,164041,3688,130024,3530,3034,1103,161007,3784,34017,3406,11690,2077
"286","22045","Iberia Parish, Louisiana",25440,1522,23861,1598,14920,1730,586,330,23275,1609,8941,1619,1579,748
"287","22051","Jefferson Parish, Louisiana",179775,1885,168281,2795,133857,3721,5187,1312,163094,3094,34424,3027,11494,1947
"288","22055","Lafayette Parish, Louisiana",97877,2532,92137,2809,74660,3580,2002,969,90135,3033,17477,2716,5740,1570
"289","22057","Lafourche Parish, Louisiana",38111,1106,34543,1503,26146,1849,457,242,34086,1532,8397,1528,3568,1053
"290","22063","Livingston Parish, Louisiana",51960,2009,50981,2015,41709,2668,1234,681,49747,2016,9272,2110,979,469
"291","22071","Orleans Parish, Louisiana",158827,2670,145670,3005,116758,3150,3683,882,141987,3242,28912,2473,13157,1445
"292","22073","Ouachita Parish, Louisiana",61594,1603,56424,1820,43976,2614,1548,599,54876,1946,12448,2108,5170,1315
"293","22079","Rapides Parish, Louisiana",48405,1798,44607,1882,31765,2287,1539,640,43068,1892,12842,1991,3798,1130
"294","22097","St. Landry Parish, Louisiana",32213,1197,28068,1452,17779,1536,886,510,27182,1542,10289,1341,4145,880
"295","22103","St. Tammany Parish, Louisiana",103543,2078,98580,2102,85440,2781,2253,929,96327,2187,13140,1724,4963,1376
"296","22105","Tangipahoa Parish, Louisiana",49915,2215,47048,2508,35788,3048,791,459,46257,2376,11260,2395,2867,1106
"297","22109","Terrebonne Parish, Louisiana",43996,1245,40080,1726,30430,2284,1175,575,38905,1806,9650,2200,3916,1286
"298","23001","Androscoggin County, Maine",46323,1134,44062,1414,37290,1473,1911,659,42151,1283,6772,1318,2261,815
"299","23003","Aroostook County, Maine",30220,828,27753,923,22331,1128,1757,475,25996,1023,5422,922,2467,518
"300","23005","Cumberland County, Maine",129977,2436,125026,2647,113553,2937,4045,876,120981,2922,11473,1942,4951,1005
"301","23011","Kennebec County, Maine",53803,1519,51201,1748,44128,2179,2269,732,48932,1908,7073,1344,2602,857
"302","23019","Penobscot County, Maine",65441,1509,61517,1570,53307,1909,3043,835,58474,1835,8210,1455,3924,925
"303","23031","York County, Maine",90907,2379,87084,2496,76111,2805,3961,1206,83123,2559,10973,1837,3823,1149
"304","24001","Allegany County, Maryland",28535,1358,26060,1341,20101,1458,2049,684,24011,1576,5959,1334,2475,566
"305","24003","Anne Arundel County, Maryland",225064,2370,219725,2523,202195,3353,4049,877,215676,2504,17530,2302,5339,1298
"306","24005","Baltimore County, Maryland",332529,2856,317160,3476,277987,4952,11706,1786,305454,3676,39173,4205,15369,2340
"307","24009","Calvert County, Maryland",33994,925,32750,1041,29621,1260,1015,627,31735,1096,3129,879,1244,511
"308","24013","Carroll County, Maryland",64161,929,61363,1007,54685,1443,1646,522,59717,1189,6678,1288,2798,660
"309","24015","Cecil County, Maryland",41000,965,38839,1229,34045,1582,1764,614,37075,1295,4794,1203,2161,976
"310","24017","Charles County, Maryland",59481,1023,58063,1076,53075,1431,592,332,57471,1122,4988,1320,1418,641
"311","24021","Frederick County, Maryland",103685,1026,100101,1315,91692,1898,2075,580,98026,1380,8409,1503,3584,768
"312","24025","Harford County, Maryland",101196,1196,98414,1553,88356,2544,2424,695,95990,1538,10058,1834,2782,854
"313","24027","Howard County, Maryland",120546,1453,119056,1505,113101,1898,2220,653,116836,1534,5955,1228,1490,589
"314","24031","Montgomery County, Maryland",388396,2483,381986,2783,355002,4018,10285,1361,371701,3044,26984,2947,6410,1347
"315","24033","Prince George's County, Maryland",346127,2426,335590,2932,295713,4364,8764,1534,326826,3220,39877,3677,10537,1552
"316","24037","St. Mary's County, Maryland",42078,1559,40171,1770,36597,1994,760,482,39411,1850,3574,1243,1907,684
"317","24043","Washington County, Maryland",60215,3547,55436,3486,44088,3291,2200,688,53236,3363,11348,1715,4779,1161
"318","24045","Wicomico County, Maryland",40577,1081,38686,1270,31034,1822,843,376,37843,1250,7652,1204,1891,702
"319","24510","Baltimore city, Maryland",254370,3581,238808,4114,194167,4972,6155,1214,232653,4212,44641,4111,15562,2402
"320","25001","Barnstable County, Massachusetts",104733,3422,101143,3450,90581,3318,5564,1192,95579,3133,10562,1631,3590,795
"321","25003","Berkshire County, Massachusetts",57765,1674,54092,1865,47390,2043,3706,1051,50386,1798,6702,1021,3673,848
"322","25005","Bristol County, Massachusetts",233531,2460,217008,3146,176816,3883,7085,1584,209923,3204,40192,3492,16523,2129
"323","25009","Essex County, Massachusetts",309972,2203,294031,2886,253331,3641,10931,1629,283100,3130,40700,2885,15941,2015
"324","25011","Franklin County, Massachusetts",30374,940,28265,1057,24601,1130,1570,421,26695,1021,3664,734,2109,690
"325","25013","Hampden County, Massachusetts",184544,2205,167330,2944,133434,3767,6274,1132,161056,2922,33896,3457,17214,1970
"326","25015","Hampshire County, Massachusetts",60870,1574,57385,1850,51545,1919,2391,711,54994,1984,5840,1351,3485,1011
"327","25017","Middlesex County, Massachusetts",632831,3283,609877,3941,557520,6321,20164,2288,589713,4523,52357,4506,22954,2731
"328","25021","Norfolk County, Massachusetts",280067,2344,270890,3019,247450,3927,12021,1776,258869,3405,23440,2888,9177,1763
"329","25023","Plymouth County, Massachusetts",202084,2543,192879,2886,170270,3262,6279,1224,186600,3358,22609,2431,9205,1332
"330","25025","Suffolk County, Massachusetts",315257,4266,301174,4491,264157,4976,7455,1692,293719,4938,37017,2973,14083,1959
"331","25027","Worcester County, Massachusetts",333435,3137,318739,3954,275789,4776,12082,1919,306657,4216,42950,3705,14696,1996
"332","26005","Allegan County, Michigan",44479,1290,42628,1382,36466,1613,1545,535,41083,1429,6162,1139,1851,609
"333","26017","Bay County, Michigan",45487,1115,42751,1243,34858,1727,1984,576,40767,1400,7893,1413,2736,661
"334","26021","Berrien County, Michigan",65764,1784,61154,1905,48807,1703,2111,509,59043,1902,12347,1611,4610,1137
"335","26025","Calhoun County, Michigan",53482,1180,49820,1450,38896,1780,1339,417,48481,1504,10924,1444,3662,810
"336","26037","Clinton County, Michigan",30952,692,29468,783,26357,1079,923,286,28545,777,3111,860,1484,449
"337","26045","Eaton County, Michigan",45137,944,43347,916,36031,1276,1576,596,41771,1110,7316,1164,1790,490
"338","26049","Genesee County, Michigan",167895,2057,156992,2423,128174,2934,5143,1130,151849,2642,28818,2445,10903,1595
"339","26055","Grand Traverse County, Michigan",40083,1465,38393,1419,33573,1873,1032,462,37361,1445,4820,1212,1690,635
"340","26065","Ingham County, Michigan",115752,1768,110783,2106,95159,2460,2283,632,108500,2127,15624,2027,4969,1201
"341","26067","Ionia County, Michigan",23531,595,21117,824,16782,928,587,284,20530,830,4335,824,2414,600
"342","26075","Jackson County, Michigan",61937,1749,58219,1930,43513,2050,1461,488,56758,2100,14706,1945,3718,995
"343","26077","Kalamazoo County, Michigan",105642,2484,100117,2516,86847,3340,3469,818,96648,2640,13270,2251,5525,1040
"344","26081","Kent County, Michigan",253092,2635,241247,3030,209131,3865,6786,1247,234461,2983,32116,2781,11845,1916
"345","26087","Lapeer County, Michigan",34447,857,31800,1085,26473,1384,1850,782,29950,1270,5327,911,2647,666
"346","26091","Lenawee County, Michigan",38963,1037,36941,1095,29937,1544,1305,366,35636,1117,7004,1254,2022,464
"347","26093","Livingston County, Michigan",75370,1117,72808,1260,66644,1653,2373,717,70435,1279,6164,945,2562,598
"348","26099","Macomb County, Michigan",358011,2226,342398,2955,289323,4723,11865,1705,330533,3096,53075,3601,15613,1787
"349","26103","Marquette County, Michigan",27290,932,25521,1050,21814,1126,1163,465,24358,1153,3707,800,1769,422
"350","26111","Midland County, Michigan",35453,601,33591,745,29007,1104,1000,403,32591,732,4584,1050,1862,556
"351","26115","Monroe County, Michigan",61574,1323,58096,1736,46705,1818,2958,765,55138,1827,11391,1509,3478,944
"352","26117","Montcalm County, Michigan",23745,954,21757,1025,16541,1173,871,342,20886,1076,5216,911,1988,443
"353","26121","Muskegon County, Michigan",67707,1344,63361,1496,48207,2223,1675,453,61686,1455,15154,2015,4346,902
"354","26125","Oakland County, Michigan",530383,3015,512936,3233,462858,4993,13893,1832,499043,3615,50078,3616,17447,1735
"355","26139","Ottawa County, Michigan",110045,1869,106488,2121,91743,2829,2448,799,104040,2149,14745,2237,3557,961
"356","26145","Saginaw County, Michigan",80146,1632,73880,2092,57802,2565,2680,767,71200,2130,16078,1905,6266,1291
"357","26147","St. Clair County, Michigan",66324,1381,62555,1725,51303,2137,2494,658,60061,1821,11252,1674,3769,805
"358","26155","Shiawassee County, Michigan",28226,795,26024,911,21035,1096,872,343,25152,927,4989,893,2202,539
"359","26159","Van Buren County, Michigan",28457,1370,26404,1567,21226,1522,1146,472,25258,1574,5178,796,2053,664
"360","26161","Washtenaw County, Michigan",149133,2646,144738,2765,132444,2959,3271,737,141467,2945,12294,1701,4395,964
"361","26163","Wayne County, Michigan",695038,4718,655472,5520,522812,7333,21538,2000,633934,5578,132660,5597,39566,3225
"362","27003","Anoka County, Minnesota",135265,1218,129545,1802,115155,2432,4791,915,124754,1740,14390,2099,5720,1190
"363","27013","Blue Earth County, Minnesota",27604,914,26451,877,22823,1257,745,379,25706,928,3628,979,1153,401
"364","27019","Carver County, Minnesota",40141,560,39607,607,35807,1143,1057,440,38550,766,3800,989,534,323
"365","27027","Clay County, Minnesota",26236,658,24509,993,21802,1184,513,413,23996,919,2707,735,1727,842
"366","27035","Crow Wing County, Minnesota",27753,1244,26472,1269,22402,1250,920,292,25552,1327,4070,742,1281,371
"367","27037","Dakota County, Minnesota",170696,1467,165516,1726,149887,2455,4480,891,161036,1905,15629,2120,5180,1034
"368","27053","Hennepin County, Minnesota",532149,3721,513868,4469,469557,5411,13313,1732,500555,4794,44311,3276,18281,2081
"369","27109","Olmsted County, Minnesota",65122,1396,62660,1431,55413,2054,1681,452,60979,1485,7247,1349,2462,719
"370","27123","Ramsey County, Minnesota",218817,2624,209210,3106,182268,3699,6854,1298,202356,3212,26942,2928,9607,1588
"371","27131","Rice County, Minnesota",23779,811,23140,821,18688,920,775,393,22365,907,4452,876,639,246
"372","27137","St. Louis County, Minnesota",85576,1941,80794,2056,65921,2391,2359,612,78435,2052,14873,1579,4782,890
"373","27139","Scott County, Minnesota",55327,381,54403,592,47015,1517,947,403,53456,731,7388,1359,924,498
"374","27141","Sherburne County, Minnesota",34738,1116,32912,1326,29543,1516,917,476,31995,1305,3369,1162,1826,814
"375","27145","Stearns County, Minnesota",62168,1126,59100,1248,50009,1858,2108,736,56992,1258,9091,1529,3068,664
"376","27163","Washington County, Minnesota",102421,1669,100275,1936,92017,2672,2863,807,97412,2019,8258,1454,2146,672
"377","27171","Wright County, Minnesota",52260,1063,50893,1086,44783,1679,920,368,49973,1170,6110,1363,1367,508
"378","28033","DeSoto County, Mississippi",68966,1500,66643,1636,52842,2561,2521,1063,64122,1850,13801,2274,2323,801
"379","28035","Forrest County, Mississippi",30600,1222,28830,1369,21060,1687,239,232,28591,1376,7770,1417,1770,687
"380","28047","Harrison County, Mississippi",81224,2336,77995,2560,63469,2955,2719,1033,75276,2711,14526,2201,3229,1116
"381","28049","Hinds County, Mississippi",91067,2508,83507,2680,62767,2928,1924,799,81583,2658,20740,2199,7560,1597
"382","28059","Jackson County, Mississippi",56984,1644,53914,1895,43107,3096,1422,602,52492,2014,10807,2395,3070,947
"383","28067","Jones County, Mississippi",23506,1325,21780,1391,13980,1758,428,425,21352,1449,7800,1676,1726,819
"384","28073","Lamar County, Mississippi",25688,851,24722,1045,19979,1377,938,653,23784,1168,4743,1396,966,625
"385","28075","Lauderdale County, Mississippi",28212,1080,24984,1398,18409,1556,930,634,24054,1567,6575,1201,3228,1013
"386","28081","Lee County, Mississippi",32722,1109,30486,1392,22265,1678,628,339,29858,1458,8221,1312,2236,871
"387","28089","Madison County, Mississippi",42558,1410,41865,1437,35327,2127,746,629,41119,1551,6538,1640,693,338
"388","28121","Rankin County, Mississippi",59894,1621,57128,1628,46820,2284,1167,655,55961,1721,10308,1957,2766,915
"389","29019","Boone County, Missouri",75036,2037,72982,1943,64873,2354,1819,667,71163,1958,8109,1631,2054,765
"390","29021","Buchanan County, Missouri",33334,1575,31838,1505,23147,1486,686,308,31152,1443,8691,1231,1496,448
"391","29031","Cape Girardeau County, Missouri",32800,1053,31130,1327,24609,1615,818,399,30312,1400,6521,1353,1670,719
"392","29037","Cass County, Missouri",42361,808,40307,1066,35118,1586,906,379,39401,1159,5189,1171,2054,708
"393","29043","Christian County, Missouri",34116,934,33355,1017,28226,1387,1317,620,32038,1153,5129,1126,761,377
"394","29047","Clay County, Missouri",100737,1635,96664,2178,82439,2525,3434,1062,93230,2322,14225,2307,4073,1318
"395","29051","Cole County, Missouri",29522,1143,27684,1235,22739,1469,1017,453,26667,1270,4945,1134,1838,688
"396","29071","Franklin County, Missouri",41301,1235,38356,1554,30717,1955,1461,628,36895,1643,7639,1502,2945,764
"397","29077","Greene County, Missouri",130986,1871,125971,2346,107345,3269,4261,1055,121710,2782,18626,2429,5015,1272
"398","29095","Jackson County, Missouri",302965,3103,291382,3485,238968,3964,8769,1639,282613,3898,52414,3832,11583,1439
"399","29097","Jasper County, Missouri",47864,1450,45306,1632,34977,2116,848,402,44458,1687,10329,1563,2558,609
"400","29099","Jefferson County, Missouri",88806,1525,83943,1820,69677,2144,2178,722,81765,1974,14266,1745,4863,1265
"401","29165","Platte County, Missouri",43201,1026,42187,1105,37586,1462,907,435,41280,1176,4601,1039,1014,506
"402","29183","St. Charles County, Missouri",157907,1697,152893,2105,142121,2788,4167,914,148726,2116,10772,1922,5014,1166
"403","29187","St. Francois County, Missouri",25030,1200,23521,1204,17528,1535,826,465,22695,1285,5993,1427,1509,537
"404","29189","St. Louis County, Missouri",412833,3561,394069,4067,343187,5541,12929,2045,381140,4372,50882,4294,18764,2138
"405","29510","St. Louis city, Missouri",139736,2863,128092,2952,99907,3388,3061,836,125031,2987,28185,2418,11644,1757
"406","30013","Cascade County, Montana",34303,1229,32647,1353,26620,1530,1331,521,31316,1416,6027,1186,1656,598
"407","30029","Flathead County, Montana",42900,1746,40966,1818,37449,1761,1737,586,39229,1891,3517,889,1934,714
"408","30031","Gallatin County, Montana",48796,1670,47747,1805,43815,1809,1513,675,46234,1873,3932,1083,1049,587
"409","30049","Lewis and Clark County, Montana",31208,837,28542,995,24797,1321,823,389,27719,1044,3745,1185,2666,798
"410","30063","Missoula County, Montana",51957,1119,49745,1329,44755,1721,1041,450,48704,1361,4990,1266,2212,770
"411","30111","Yellowstone County, Montana",69001,1329,67146,1451,58139,2013,1987,602,65159,1535,9007,1474,1855,656
"412","31055","Douglas County, Nebraska",236106,2240,226146,2446,192475,3593,6021,875,220125,2639,33671,3203,9960,1373
"413","31109","Lancaster County, Nebraska",131417,1723,126618,2092,109809,2741,4259,1125,122359,2312,16809,1935,4799,1106
"414","31153","Sarpy County, Nebraska",72428,939,70866,1139,63549,1692,2488,783,68378,1245,7317,1189,1562,589
"415","32003","Clark County, Nevada",854289,5987,824126,6507,699214,7588,24318,2295,799808,6735,124912,5597,30163,2970
"416","32031","Washoe County, Nevada",198018,2117,190977,2528,167708,3475,6041,1277,184936,2654,23269,2459,7041,1388
"417","33005","Cheshire County, New Hampshire",28266,1444,26038,1405,21660,1406,2004,546,24034,1553,4378,980,2228,647
"418","33009","Grafton County, New Hampshire",35199,1408,33587,1545,30671,1604,2515,778,31072,1719,2916,883,1612,536
"419","33011","Hillsborough County, New Hampshire",167899,1858,162591,2004,145425,2789,5094,1129,157497,2273,17166,2289,5308,1181
"420","33013","Merrimack County, New Hampshire",58733,1291,56402,1300,50002,1682,2474,726,53928,1386,6400,1184,2331,649
"421","33015","Rockingham County, New Hampshire",127882,1836,123976,1973,113738,2440,3625,938,120351,1987,10238,1607,3906,1014
"422","33017","Strafford County, New Hampshire",52067,1277,50828,1367,45746,1671,2353,727,48475,1448,5082,1225,1239,549
"423","34001","Atlantic County, New Jersey",112299,2238,105704,2403,90039,2337,4158,1002,101546,2566,15665,1846,6595,1323
"424","34003","Bergen County, New Jersey",352030,2288,339458,2936,308493,4005,9318,1486,330140,3280,30965,3018,12572,1732
"425","34005","Burlington County, New Jersey",175859,2061,168993,2275,153721,2922,5629,1271,163364,2757,15272,1878,6866,1287
"426","34007","Camden County, New Jersey",201158,2198,191716,2648,164134,3766,7026,1554,184690,2822,27582,2908,9442,1628
"427","34009","Cape May County, New Jersey",48860,1584,46794,1638,40410,1856,1374,539,45420,1703,6384,1336,2066,614
"428","34011","Cumberland County, New Jersey",53883,1910,51289,1999,40578,2503,2589,972,48700,2047,10711,1802,2594,850
"429","34013","Essex County, New Jersey",322453,2168,305593,3656,253125,5109,7783,1708,297810,4247,52468,4651,16860,2433
"430","34015","Gloucester County, New Jersey",112502,1548,108378,1787,95896,2359,2852,756,105526,1884,12482,1684,4124,1116
"431","34017","Hudson County, New Jersey",292000,3564,277147,4067,243366,4901,5721,1231,271426,4251,33781,3576,14853,2494
"432","34019","Hunterdon County, New Jersey",51292,953,49548,1220,45571,1526,1541,555,48007,1310,3977,940,1744,676
"433","34021","Mercer County, New Jersey",143970,1875,136325,2238,117030,3025,4547,1069,131778,2618,19295,2220,7645,1533
"434","34023","Middlesex County, New Jersey",307831,1897,297159,2252,262614,2900,7934,1291,289225,2457,34545,2815,10672,1649
"435","34025","Monmouth County, New Jersey",250738,2780,240151,3592,218799,3849,7245,1387,232906,3596,21352,2639,10587,2061
"436","34027","Morris County, New Jersey",192847,2063,186557,2237,174630,2709,4361,958,182196,2395,11927,1726,6290,1554
"437","34029","Ocean County, New Jersey",240736,3262,222257,3546,198591,4422,16371,2043,205886,3812,23666,2914,18479,2344
"438","34031","Passaic County, New Jersey",177063,1586,166159,2391,140575,3537,5261,1121,160898,2611,25584,2756,10904,1759
"439","34033","Salem County, New Jersey",24973,886,23429,999,19567,1034,876,337,22553,987,3862,963,1544,533
"440","34035","Somerset County, New Jersey",130939,1059,126996,1548,119521,2149,2764,870,124232,1946,7475,1501,3943,1127
"441","34037","Sussex County, New Jersey",58767,1022,56775,1025,51719,1350,2395,653,54380,1295,5056,950,1992,499
"442","34039","Union County, New Jersey",201392,1846,194122,2207,168341,3185,6631,1440,187491,2501,25781,2988,7270,1426
"443","34041","Warren County, New Jersey",46353,386,43651,966,38597,1254,1562,533,42089,1061,5054,1084,2702,834
"444","35001","Bernalillo County, New Mexico",285185,2283,274602,2807,232457,4408,7836,1545,266766,3003,42145,3619,10583,1516
"445","35013","Doña Ana County, New Mexico",85021,1855,80661,2345,65889,2951,2197,1183,78464,2624,14772,2562,4360,1234
"446","35025","Lea County, New Mexico",24390,1576,22967,1674,16100,1895,743,566,22224,1693,6867,1504,1423,639
"447","35031","McKinley County, New Mexico",20949,597,16043,965,11883,1030,486,230,15557,1005,4160,883,4906,861
"448","35035","Otero County, New Mexico",24034,1534,22618,1609,17726,1585,998,580,21620,1488,4892,1168,1416,679
"449","35043","Sandoval County, New Mexico",56655,912,54355,998,48534,1623,1935,826,52420,1314,5821,1283,2300,613
"450","35045","San Juan County, New Mexico",40844,1195,36795,1412,24586,1872,736,337,36059,1565,12209,1857,4049,983
"451","35049","Santa Fe County, New Mexico",70152,1723,66261,1819,58044,2387,2471,624,63790,1918,8217,1591,3891,1060
"452","35061","Valencia County, New Mexico",28875,912,26713,1322,21427,1349,1547,582,25166,1392,5286,1053,2162,914
"453","36001","Albany County, New York",132171,2699,124304,2951,110288,3606,5076,1102,119228,3083,14016,2434,7867,1351
"454","36005","Bronx County, New York",533004,2823,497168,5124,363114,7969,13617,2405,483551,4985,134054,7040,35836,4012
"455","36007","Broome County, New York",84452,1853,78338,2050,65206,2468,3529,795,74809,2171,13132,1847,6114,1013
"456","36009","Cattaraugus County, New York",32562,1111,29274,1209,22087,1242,1636,490,27638,1331,7187,1010,3288,503
"457","36011","Cayuga County, New York",32392,1168,29339,1294,23770,1455,1468,474,27871,1251,5569,842,3053,660
"458","36013","Chautauqua County, New York",53309,1824,48723,1873,39050,1724,2482,635,46241,1986,9673,1425,4586,895
"459","36015","Chemung County, New York",35407,1340,32483,1329,26331,1446,1290,475,31193,1374,6152,1065,2924,729
"460","36019","Clinton County, New York",33860,1189,32125,1323,28451,1391,1543,482,30582,1343,3674,945,1735,560
"461","36027","Dutchess County, New York",118175,1640,113363,2069,99998,2476,5082,1214,108281,2422,13365,2043,4812,967
"462","36029","Erie County, New York",412870,3039,385461,3804,321802,6138,16223,1893,369238,4062,63659,4784,27409,2845
"463","36045","Jefferson County, New York",48628,1708,45952,2024,40724,2247,1909,699,44043,2154,5228,1212,2676,831
"464","36047","Kings County, New York",1001868,4824,932424,5704,796323,8392,30575,3111,901849,5672,136101,6400,69444,4539
"465","36053","Madison County, New York",25294,1182,23683,1345,21023,1294,1448,512,22235,1429,2660,641,1611,640
"466","36055","Monroe County, New York",318883,2606,301432,3339,255410,4453,11302,1548,290130,3430,46022,3430,17451,1951
"467","36059","Nassau County, New York",459452,2941,442138,3812,403609,4887,13195,1653,428943,4119,38529,3495,17314,2035
"468","36061","New York County, New York",737575,9878,699893,10112,618174,8866,19079,3049,680814,9998,81719,5540,37682,4656
"469","36063","Niagara County, New York",90975,1647,84661,1956,70186,2723,5452,997,79209,2026,14475,2108,6314,1294
"470","36065","Oneida County, New York",93373,1918,86525,2092,67630,2554,4404,974,82121,2104,18895,2122,6848,1315
"471","36067","Onondaga County, New York",198132,1949,188293,2410,158667,2767,5703,1030,182590,2362,29626,2433,9839,1618
"472","36069","Ontario County, New York",47607,1296,45415,1396,39855,1429,2036,638,43379,1491,5560,1176,2192,677
"473","36071","Orange County, New York",137561,2000,128771,2026,112625,2922,4918,1137,123853,2325,16146,2178,8790,1323
"474","36075","Oswego County, New York",46924,1302,43809,1344,34877,1753,2466,741,41343,1538,8932,1415,3115,809
"475","36079","Putnam County, New York",35166,931,34218,1056,30698,1450,1643,691,32575,1170,3520,1032,948,460
"476","36081","Queens County, New York",820686,5706,784318,5902,653275,8186,20838,2574,763480,6270,131043,7363,36368,3143
"477","36083","Rensselaer County, New York",66431,1537,62820,1593,54983,2178,2568,854,60252,1861,7837,1580,3611,820
"478","36085","Richmond County, New York",170762,2191,160116,3020,140625,3373,6444,1360,153672,3133,19491,2549,10646,2309
"479","36087","Rockland County, New York",102609,1397,94286,1889,84407,2303,5451,1066,88835,2076,9879,1777,8323,1223
"480","36089","St. Lawrence County, New York",42298,1493,39309,1621,31769,1661,2027,625,37282,1756,7540,1354,2989,694
"481","36091","Saratoga County, New York",100226,2027,95418,2445,81831,2767,3110,935,92308,2376,13587,2355,4808,1134
"482","36093","Schenectady County, New York",66910,1367,62619,1802,54506,2079,3392,907,59227,1897,8113,1583,4291,1052
"483","36101","Steuben County, New York",39500,1100,36035,1237,30162,1338,1716,395,34319,1348,5873,848,3465,804
"484","36103","Suffolk County, New York",511951,4112,496879,4582,453099,5921,16297,1911,480582,4693,43780,3616,15072,2114
"485","36105","Sullivan County, New York",32529,1943,30403,2038,23256,1926,1684,551,28719,2112,7147,1997,2126,714
"486","36109","Tompkins County, New York",44469,1433,42581,1749,40403,1913,1996,751,40585,1900,2178,698,1888,1286
"487","36111","Ulster County, New York",75053,2057,71208,2350,63533,2409,3076,730,68132,2313,7675,1717,3845,1116
"488","36113","Warren County, New York",29729,1198,27696,1425,23627,1620,1396,447,26300,1553,4069,1070,2033,721
"489","36117","Wayne County, New York",38634,989,36631,1101,30587,1322,1871,521,34760,1211,6044,1153,2003,547
"490","36119","Westchester County, New York",371736,3135,357208,3570,318327,4622,10514,1781,346694,3877,38881,3613,14528,2126
"491","37001","Alamance County, North Carolina",69343,1462,65557,1769,53878,2364,2369,802,63188,1703,11679,1803,3786,1016
"492","37019","Brunswick County, North Carolina",65337,2335,63250,2485,55852,2858,2202,826,61048,2594,7398,1483,2087,745
"493","37021","Buncombe County, North Carolina",97345,3398,88313,3490,78862,3580,2398,780,85915,3410,9451,1645,9032,1826
"494","37023","Burke County, North Carolina",35709,1226,32212,1674,24428,1559,1294,571,30918,1649,7784,1253,3497,1006
"495","37025","Cabarrus County, North Carolina",73486,2341,71302,2356,62986,2562,1387,553,69915,2367,8316,1726,2184,958
"496","37027","Caldwell County, North Carolina",32600,1306,28860,1551,21977,1876,1059,518,27801,1505,6883,1657,3740,835
"497","37031","Carteret County, North Carolina",30589,1439,29678,1516,25439,1560,699,294,28979,1542,4239,844,911,384
"498","37035","Catawba County, North Carolina",64302,2000,60317,2266,46708,2696,1537,636,58780,2268,13609,2312,3985,963
"499","37037","Chatham County, North Carolina",31474,1350,29984,1367,24815,1558,984,489,29000,1429,5169,1499,1490,540
"500","37045","Cleveland County, North Carolina",40296,1013,36352,1335,26626,1691,774,431,35578,1379,9726,1493,3944,1185
"501","37049","Craven County, North Carolina",42139,1778,39012,1849,32991,2092,904,370,38108,1927,6021,1373,3127,942
"502","37051","Cumberland County, North Carolina",129898,1813,122270,1992,103131,2503,2990,803,119280,2100,19139,1717,7628,1089
"503","37057","Davidson County, North Carolina",66245,2124,63056,2457,48819,2586,2504,805,60552,2495,14237,2310,3189,1152
"504","37063","Durham County, North Carolina",138497,2458,134839,2738,120532,3871,2430,837,132409,2737,14307,2754,3658,1196
"505","37067","Forsyth County, North Carolina",155985,2725,147870,2995,127926,3565,4451,1159,143419,2918,19944,2530,8115,1558
"506","37069","Franklin County, North Carolina",26689,1191,25250,1348,19562,1606,556,390,24694,1325,5688,1315,1439,628
"507","37071","Gaston County, North Carolina",93913,1561,87997,1935,70248,2649,3248,724,84749,2024,17749,2168,5916,1080
"508","37081","Guilford County, North Carolina",212574,3591,203490,3843,174199,4581,5975,1230,197515,3884,29291,3216,9084,1713
"509","37085","Harnett County, North Carolina",49555,932,46217,1213,35890,1574,1214,422,45003,1185,10327,1347,3338,771
"510","37089","Henderson County, North Carolina",50136,1729,47388,1908,41139,2035,1377,493,46011,1885,6249,1284,2748,1170
"511","37097","Iredell County, North Carolina",73434,1555,70043,1912,59378,2281,2251,747,67792,2072,10665,1404,3391,980
"512","37101","Johnston County, North Carolina",82113,1827,78835,2172,68190,2355,1477,1039,77358,2403,10645,2029,3278,1121
"513","37109","Lincoln County, North Carolina",36361,980,34800,1136,29721,1384,708,367,34092,1196,5079,1223,1561,654
"514","37119","Mecklenburg County, North Carolina",458344,3745,444941,4519,398600,6149,7828,1492,437113,4627,46341,4570,13403,2054
"515","37125","Moore County, North Carolina",43554,1598,41367,1756,33880,2188,1461,559,39906,1713,7487,1620,2187,749
"516","37127","Nash County, North Carolina",38029,1302,34678,1662,27907,2012,1744,786,32934,1704,6771,1625,3351,1025
"517","37129","New Hanover County, North Carolina",103762,2532,100164,2889,87667,3704,2162,810,98002,3163,12497,2081,3598,1229
"518","37133","Onslow County, North Carolina",73121,2635,71078,2627,60394,3315,2414,1376,68664,2813,10684,2467,2043,815
"519","37135","Orange County, North Carolina",56263,1978,54675,2087,49721,2537,1842,639,52833,2062,4954,1332,1588,661
"520","37147","Pitt County, North Carolina",75578,1506,69416,2174,59422,2945,3087,1168,66329,2110,9994,2054,6162,1631
"521","37151","Randolph County, North Carolina",55948,1599,51988,1874,41763,2065,1746,730,50242,1893,10225,1766,3960,1011
"522","37155","Robeson County, North Carolina",43529,720,38793,973,26603,1303,1158,427,37635,1031,12190,1314,4736,673
"523","37157","Rockingham County, North Carolina",38481,1437,33323,1708,24514,2062,1860,666,31463,1696,8809,1883,5158,1135
"524","37159","Rowan County, North Carolina",57024,1888,53776,1932,43278,2503,1670,466,52106,1933,10498,2140,3248,753
"525","37171","Surry County, North Carolina",30317,965,27718,1156,21962,1408,1255,452,26463,1183,5756,1150,2599,667
"526","37179","Union County, North Carolina",83407,1084,81079,1229,70726,2117,1498,577,79581,1314,10353,2144,2328,773
"527","37183","Wake County, North Carolina",439911,4545,431127,4749,397839,5381,7982,1333,423145,4915,33288,4195,8784,1849
"528","37191","Wayne County, North Carolina",46932,1466,42885,1727,34049,1774,2540,778,40345,1869,8836,1468,4047,1055
"529","37193","Wilkes County, North Carolina",26770,1302,23823,1514,18239,1745,1136,529,22687,1537,5584,1291,2947,908
"530","37195","Wilson County, North Carolina",32868,1009,28270,1429,22076,1645,1497,772,26773,1490,6194,1343,4598,997
"531","38015","Burleigh County, North Dakota",39295,1331,36728,1474,31489,1625,865,332,35863,1484,5239,1200,2567,783
"532","38017","Cass County, North Dakota",83761,1254,81175,1543,70285,2285,2231,841,78944,1749,10890,1711,2586,851
"533","38035","Grand Forks County, North Dakota",31152,1133,29752,1276,26081,1632,1160,459,28592,1326,3671,1237,1400,535
"534","38101","Ward County, North Dakota",28795,1376,27709,1314,24057,1653,725,469,26984,1443,3652,1034,1086,443
"535","39003","Allen County, Ohio",41021,1131,37174,1427,29597,1667,1055,351,36119,1411,7577,1131,3847,976
"536","39007","Ashtabula County, Ohio",39915,1458,35842,1515,27870,1384,2008,516,33834,1680,7972,1214,4073,934
"537","39013","Belmont County, Ohio",26949,1150,23078,1304,17717,1343,1418,566,21660,1332,5361,985,3871,858
"538","39017","Butler County, Ohio",146057,1908,139045,2117,115653,3114,3505,880,135540,2173,23392,2728,7012,1121
"539","39023","Clark County, Ohio",57013,1188,53483,1338,41502,1747,1831,476,51652,1361,11981,1392,3530,710
"540","39025","Clermont County, Ohio",84219,1128,78825,1652,65767,2386,2896,803,75929,1818,13058,1960,5394,1217
"541","39029","Columbiana County, Ohio",41047,1591,37293,1699,27697,1679,1602,482,35691,1645,9596,1576,3754,957
"542","39035","Cuyahoga County, Ohio",557572,3771,517631,4382,423915,5696,18122,1952,499509,4813,93716,5516,39941,2964
"543","39041","Delaware County, Ohio",80640,1159,79300,1261,74760,1768,1747,641,77553,1284,4540,1303,1340,468
"544","39043","Erie County, Ohio",32926,1361,30128,1486,23608,1618,1647,642,28481,1537,6520,1251,2798,968
"545","39045","Fairfield County, Ohio",59818,932,57049,1375,49499,1721,1505,619,55544,1576,7550,1379,2769,874
"546","39049","Franklin County, Ohio",549475,3510,531376,4321,453021,6373,11068,1584,520308,4561,78355,5113,18099,2526
"547","39055","Geauga County, Ohio",35431,949,32608,1078,29218,1220,826,309,31782,1088,3390,856,2823,661
"548","39057","Greene County, Ohio",67822,1311,64734,1561,57018,2104,1636,550,63098,1657,7716,1378,3088,822
"549","39061","Hamilton County, Ohio",353674,3201,333706,4201,285689,5456,11266,1732,322440,4480,48017,3910,19968,2533
"550","39063","Hancock County, Ohio",31951,868,30070,1118,24226,1615,966,440,29104,1224,5844,1202,1881,652
"551","39085","Lake County, Ohio",99990,1627,95019,1959,83548,2508,3346,627,91673,1972,11471,1748,4971,856
"552","39089","Licking County, Ohio",67761,1343,63827,1803,55134,1920,2592,599,61235,1813,8693,1383,3934,933
"553","39093","Lorain County, Ohio",124879,2222,118402,2505,97799,2838,4850,1066,113552,2736,20603,2033,6477,1413
"554","39095","Lucas County, Ohio",184315,2369,172462,2812,138794,3681,6668,1283,165794,2805,33668,3382,11853,1651
"555","39099","Mahoning County, Ohio",98924,1679,89766,2168,72073,2533,3090,747,86676,2229,17693,1945,9158,1342
"556","39101","Marion County, Ohio",24692,982,23034,1037,18435,1165,1169,446,21865,1143,4599,1067,1658,607
"557","39103","Medina County, Ohio",72233,1130,68886,1298,61036,2056,1946,588,66940,1367,7850,1432,3347,805
"558","39109","Miami County, Ohio",43896,1025,40765,1303,35069,1648,2129,715,38636,1435,5696,1144,3131,952
"559","39113","Montgomery County, Ohio",226787,3159,214497,3376,177026,4021,8523,1476,205974,3583,37471,2888,12290,1545
"560","39119","Muskingum County, Ohio",33876,1324,30445,1444,23463,1701,1169,402,29276,1475,6982,1385,3431,945
"561","39133","Portage County, Ohio",63096,2118,58820,2277,49980,2374,2851,998,55969,2170,8840,1754,4276,1117
"562","39139","Richland County, Ohio",49536,1560,44726,1873,34087,1978,2435,830,42291,2039,10639,1531,4810,1113
"563","39141","Ross County, Ohio",30550,843,27750,1187,23015,1414,1519,714,26231,1314,4735,1005,2800,877
"564","39145","Scioto County, Ohio",27496,1254,24884,1347,18403,1586,1472,534,23412,1445,6481,1146,2612,790
"565","39151","Stark County, Ohio",156111,2105,146459,2867,117337,3539,5599,1052,140860,2828,29122,2610,9652,1722
"566","39153","Summit County, Ohio",229060,2622,217957,3010,181784,3051,7647,1314,210310,3180,36173,2880,11103,1737
"567","39155","Trumbull County, Ohio",84911,1859,76958,2192,58734,2490,2931,752,74027,2204,18224,2116,7953,1168
"568","39157","Tuscarawas County, Ohio",38684,747,35531,910,25659,1393,1082,416,34449,959,9872,1361,3153,724
"569","39165","Warren County, Ohio",89396,1950,87015,1845,79394,2037,1306,551,85709,1946,7621,1384,2381,1032
"570","39169","Wayne County, Ohio",44215,1592,38378,1753,31610,1815,2122,572,36256,1719,6768,1233,5837,990
"571","39173","Wood County, Ohio",54012,1310,52183,1492,45585,1862,1384,506,50799,1535,6598,1119,1829,607
"572","40017","Canadian County, Oklahoma",57753,1305,55626,1537,49224,1846,1173,574,54453,1619,6402,1439,2127,923
"573","40027","Cleveland County, Oklahoma",116142,1738,112243,1847,95702,2500,3307,911,108936,2134,16541,2056,3899,1173
"574","40031","Comanche County, Oklahoma",44822,1572,42995,1662,33846,1898,1012,434,41983,1723,9149,1462,1827,584
"575","40037","Creek County, Oklahoma",28339,452,26863,550,20788,826,946,326,25917,534,6075,779,1476,382
"576","40101","Muskogee County, Oklahoma",25965,673,23820,836,16225,1059,741,328,23079,809,7595,1004,2145,540
"577","40109","Oklahoma County, Oklahoma",324819,3451,310082,3542,247808,5359,7395,1321,302687,3899,62274,4039,14737,1993
"578","40119","Payne County, Oklahoma",31537,1554,29726,1676,25178,1831,548,348,29178,1648,4548,1155,1811,725
"579","40125","Pottawatomie County, Oklahoma",26650,684,24983,792,17607,1047,536,243,24447,886,7376,935,1667,405
"580","40131","Rogers County, Oklahoma",35815,626,34105,660,28098,897,825,298,33280,723,6007,743,1710,367
"581","40143","Tulsa County, Oklahoma",270263,1542,257384,2131,210664,2749,7447,921,249937,2208,46720,2133,12879,1322
"582","40145","Wagoner County, Oklahoma",30502,559,29432,670,23707,930,810,310,28622,660,5725,863,1070,379
"583","41003","Benton County, Oregon",39350,903,38144,1145,35748,1408,1548,645,36596,1305,2396,845,1206,657
"584","41005","Clackamas County, Oregon",161945,2067,158831,2254,144335,3185,4189,1013,154642,2400,14496,2385,3114,965
"585","41017","Deschutes County, Oregon",83763,2592,82403,2694,74355,2583,2205,804,80198,2605,8048,1930,1360,674
"586","41019","Douglas County, Oregon",45981,1176,42268,1463,34371,2000,3284,896,38984,1708,7897,1759,3713,1051
"587","41029","Jackson County, Oregon",90817,1850,86399,2279,73921,2665,3914,1136,82485,2452,12478,1750,4418,1021
"588","41033","Josephine County, Oregon",36755,1155,34260,1339,28110,1829,2541,809,31719,1500,6150,1309,2495,825
"589","41035","Klamath County, Oregon",28888,1116,27671,1211,21875,1349,1525,605,26146,1330,5796,1228,1217,477
"590","41039","Lane County, Oregon",160158,1736,155257,1991,137769,2618,5110,1091,150147,1993,17488,2065,4901,1031
"591","41043","Linn County, Oregon",51347,743,49084,985,40951,1423,1770,621,47314,1111,8133,1281,2263,795
"592","41047","Marion County, Oregon",124719,2010,119621,2524,104052,3036,4307,910,115314,2619,15569,2136,5098,1459
"593","41051","Multnomah County, Oregon",348216,3420,338047,3523,307358,3664,7132,1253,330915,3820,30689,2580,10169,1625
"594","41053","Polk County, Oregon",33425,797,32100,992,28028,1305,859,459,31241,1091,4072,992,1325,590
"595","41059","Umatilla County, Oregon",27247,1324,24743,1489,20132,1781,608,297,24135,1556,4611,1310,2504,865
"596","41067","Washington County, Oregon",233615,1719,227689,2036,209028,3769,5842,1228,221847,2247,18661,3134,5926,1195
"597","41071","Yamhill County, Oregon",38988,829,37541,897,32152,1672,1421,523,36120,1060,5389,1376,1447,538
"598","42001","Adams County, Pennsylvania",39986,1008,37317,1189,31521,1390,1893,469,35424,1233,5796,1053,2669,688
"599","42003","Allegheny County, Pennsylvania",545892,4679,514635,4941,444058,6149,17849,1873,496786,5043,70577,4711,31257,2336
"600","42005","Armstrong County, Pennsylvania",27796,778,24478,1058,19952,1093,1266,434,23212,1042,4526,812,3318,675
"601","42007","Beaver County, Pennsylvania",71450,1758,65502,1995,52751,2215,2458,820,63044,1964,12751,1593,5948,1118
"602","42011","Berks County, Pennsylvania",164312,2001,152029,2718,124768,3334,6033,939,145996,2957,27261,2485,12283,1603
"603","42013","Blair County, Pennsylvania",49795,1439,44507,1424,36641,1593,1980,562,42527,1443,7866,990,5288,850
"604","42017","Bucks County, Pennsylvania",248122,1700,239034,2241,214890,3374,8115,1560,230919,2678,24144,2690,9088,1490
"605","42019","Butler County, Pennsylvania",81220,1219,76017,1523,65130,1658,2730,666,73287,1675,10887,1502,5203,873
"606","42021","Cambria County, Pennsylvania",55283,1507,49654,1664,39840,1563,2638,532,47016,1634,9814,1214,5629,865
"607","42025","Carbon County, Pennsylvania",26810,1390,24893,1564,21225,1642,2067,719,22826,1619,3668,898,1917,747
"608","42027","Centre County, Pennsylvania",57518,1860,53325,1922,48664,2253,2267,722,51058,1930,4661,1270,4193,1026
"609","42029","Chester County, Pennsylvania",204047,1763,196693,2297,181572,2715,6176,1113,190517,2372,15121,2283,7354,1493
"610","42033","Clearfield County, Pennsylvania",31570,1077,28110,1315,22614,1244,1829,516,26281,1458,5496,986,3460,631
"611","42039","Crawford County, Pennsylvania",32896,1236,29063,1182,23044,1218,2200,624,26863,1353,6019,818,3833,582
"612","42041","Cumberland County, Pennsylvania",104768,1675,99493,1804,89051,2314,4011,956,95482,2060,10442,1811,5275,1063
"613","42043","Dauphin County, Pennsylvania",120423,1641,112766,1866,95141,2988,3768,885,108998,2025,17625,2509,7657,1221
"614","42045","Delaware County, Pennsylvania",218280,2108,208309,2517,183192,3459,7608,1372,200701,2659,25117,2678,9971,1616
"615","42049","Erie County, Pennsylvania",110561,2006,103603,2391,81953,2868,5614,1138,97989,2568,21650,2116,6958,1207
"616","42051","Fayette County, Pennsylvania",55986,1422,50519,1673,38408,1707,2203,769,48316,1718,12111,1484,5467,1046
"617","42055","Franklin County, Pennsylvania",62081,1420,57609,1668,48530,2338,2245,661,55364,1772,9079,1673,4472,893
"618","42063","Indiana County, Pennsylvania",32956,1316,29564,1411,23915,1454,2072,564,27492,1436,5649,917,3392,694
"619","42069","Lackawanna County, Pennsylvania",88294,1840,81551,2119,65551,2417,3564,885,77987,2261,16000,1971,6743,1281
"620","42071","Lancaster County, Pennsylvania",210063,1967,192139,2366,164458,3835,7857,1186,184282,2417,27681,2763,17924,1821
"621","42073","Lawrence County, Pennsylvania",36286,968,32823,1279,25284,1352,1588,376,31235,1363,7539,1288,3463,820
"622","42075","Lebanon County, Pennsylvania",54906,1278,51575,1366,41036,1657,2841,735,48734,1389,10539,1465,3331,837
"623","42077","Lehigh County, Pennsylvania",141505,1666,131977,2383,112577,3315,5479,1076,126498,2498,19400,2571,9528,1548
"624","42079","Luzerne County, Pennsylvania",134132,2350,122007,2665,97794,2789,5562,1101,116445,2745,24213,2404,12125,1409
"625","42081","Lycoming County, Pennsylvania",47022,1194,43554,1320,35447,1697,2300,648,41254,1400,8107,1632,3468,700
"626","42085","Mercer County, Pennsylvania",46701,985,41332,1345,32494,1640,2195,618,39137,1382,8838,1206,5369,908
"627","42089","Monroe County, Pennsylvania",65907,2309,62978,2553,54808,3087,1590,694,61388,2758,8170,2478,2929,872
"628","42091","Montgomery County, Pennsylvania",335248,2331,323200,2944,298424,3171,8259,1204,314941,3191,24776,2388,12048,1600
"629","42095","Northampton County, Pennsylvania",122615,1475,116122,1813,98747,2675,5742,1246,110380,2010,17375,2278,6493,1384
"630","42097","Northumberland County, Pennsylvania",37823,1020,33583,1334,26789,1324,2181,685,31402,1561,6794,1298,4240,782
"631","42101","Philadelphia County, Pennsylvania",660921,5390,615941,6427,504748,8502,25721,2759,590220,6462,111193,6142,44980,4598
"632","42107","Schuylkill County, Pennsylvania",58212,1535,52460,1708,42227,2015,3072,740,49388,1773,10233,1638,5752,899
"633","42111","Somerset County, Pennsylvania",29115,1098,25507,1080,18758,1297,2083,545,23424,1121,6749,882,3608,567
"634","42125","Washington County, Pennsylvania",88544,1808,81551,1971,67784,1999,2702,833,78849,2088,13767,1553,6993,1038
"635","42129","Westmoreland County, Pennsylvania",154810,1886,141640,2317,117067,2821,6986,1222,134654,2706,24573,2705,13170,1599
"636","42133","York County, Pennsylvania",178898,1648,168189,2129,143043,3040,5791,1123,162398,2511,25146,2848,10709,1596
"637","44003","Kent County, Rhode Island",73182,1154,69299,1514,58726,2160,2738,820,66561,1821,10573,1992,3883,1042
"638","44005","Newport County, Rhode Island",38311,1242,36805,1336,32560,1612,1089,487,35716,1434,4245,1082,1506,544
"639","44007","Providence County, Rhode Island",254178,3157,239714,3618,191251,4878,8489,1565,231225,3823,48463,3226,14464,1949
"640","44009","Washington County, Rhode Island",54044,1863,52205,1889,47335,2199,1632,642,50573,1887,4870,1101,1839,721
"641","45003","Aiken County, South Carolina",67224,2297,62620,2528,51553,2560,1987,782,60633,2371,11067,2000,4604,1198
"642","45007","Anderson County, South Carolina",82203,1762,78492,2028,61849,2620,2577,941,75915,2267,16643,2301,3711,1050
"643","45013","Beaufort County, South Carolina",76249,2159,73713,2430,65062,2527,948,471,72765,2473,8651,1652,2536,948
"644","45015","Berkeley County, South Carolina",88092,2416,85041,2497,73147,2778,2060,816,82981,2471,11894,2014,3051,845
"645","45019","Charleston County, South Carolina",169851,4362,163950,4601,139944,4592,4114,1199,159836,4523,24006,2858,5901,1401
"646","45035","Dorchester County, South Carolina",58435,2005,56704,1975,49314,2620,1346,808,55358,2051,7390,1939,1731,747
"647","45041","Florence County, South Carolina",51484,1567,46200,1956,34928,2235,1136,558,45064,1997,11272,1716,5284,1133
"648","45045","Greenville County, South Carolina",212333,2761,203429,3046,171427,3852,5685,1062,197744,3301,32002,3214,8904,1382
"649","45047","Greenwood County, South Carolina",26577,1376,24585,1478,19358,1563,941,412,23644,1506,5227,1195,1992,650
"650","45051","Horry County, South Carolina",145335,3779,140108,3723,109247,3804,4871,1156,135237,3713,30861,3008,5227,1071
"651","45055","Kershaw County, South Carolina",25412,1126,23999,1225,19785,1408,596,377,23403,1295,4214,1144,1413,725
"652","45057","Lancaster County, South Carolina",38570,1857,36167,2088,30627,2250,1129,645,35038,2130,5540,1481,2403,958
"653","45059","Laurens County, South Carolina",26580,1241,24411,1416,18955,1386,232,184,24179,1427,5456,1205,2169,664
"654","45063","Lexington County, South Carolina",120968,1676,115372,2024,97122,2967,3220,874,112152,1937,18250,2272,5596,1323
"655","45073","Oconee County, South Carolina",34023,1677,31974,1851,23336,1786,993,529,30981,1887,8638,1335,2049,748
"656","45075","Orangeburg County, South Carolina",32017,1702,27542,1685,21183,1587,924,408,26618,1710,6359,1163,4475,853
"657","45077","Pickens County, South Carolina",51996,1673,48364,1869,38792,2349,2027,845,46337,1966,9572,1571,3632,967
"658","45079","Richland County, South Carolina",166515,2720,161266,3028,134454,4167,4387,1163,156879,3241,26812,3404,5249,1343
"659","45083","Spartanburg County, South Carolina",128437,2343,121649,2549,93614,3454,3814,897,117835,2774,28035,2911,6788,1499
"660","45085","Sumter County, South Carolina",43191,1244,38505,1660,29147,2092,1542,813,36963,1832,9358,1648,4686,1139
"661","45091","York County, South Carolina",113195,1371,109075,1697,93427,3122,2760,1316,106315,2304,15648,2768,4120,1175
"662","46083","Lincoln County, South Dakota",26565,604,25732,845,24112,1035,1074,746,24658,1209,1620,634,833,594
"663","46099","Minnehaha County, South Dakota",82289,1593,79957,1703,68499,2422,1561,440,78396,1733,11458,1856,2332,743
"664","46103","Pennington County, South Dakota",46296,1257,43730,1370,36859,1762,2169,759,41561,1447,6871,1144,2566,742
"665","47001","Anderson County, Tennessee",31735,1319,29636,1576,22833,1814,1160,491,28476,1546,6803,1261,2099,739
"666","47009","Blount County, Tennessee",55446,1377,52889,1520,43597,1964,1381,506,51508,1690,9292,1802,2557,791
"667","47011","Bradley County, Tennessee",43025,1272,39865,1583,30794,2157,1530,662,38335,1652,9071,1661,3160,921
"668","47037","Davidson County, Tennessee",316273,3566,304448,3788,264183,5400,6352,1283,298096,3908,40265,4771,11825,2343
"669","47059","Greene County, Tennessee",28585,1204,25217,1604,19389,1584,998,601,24219,1732,5828,1133,3368,836
"670","47065","Hamilton County, Tennessee",151676,2487,144580,2665,120536,3399,3251,956,141329,2690,24044,2859,7096,1259
"671","47093","Knox County, Tennessee",198914,2359,189687,2771,158889,3370,3504,877,186183,2918,30798,2456,9227,1462
"672","47113","Madison County, Tennessee",39730,1226,35614,1476,27391,1516,686,365,34928,1491,8223,1386,4116,1086
"673","47119","Maury County, Tennessee",41309,1283,40225,1387,34546,1653,598,346,39627,1360,5679,1352,1084,548
"674","47125","Montgomery County, Tennessee",84145,1514,81440,1885,71209,2670,1967,1103,79473,2047,10231,1794,2705,1195
"675","47141","Putnam County, Tennessee",33652,1163,31705,1279,27431,1462,1030,541,30675,1475,4274,953,1947,783
"676","47147","Robertson County, Tennessee",27233,760,25585,936,21201,1346,556,312,25029,924,4384,1045,1648,554
"677","47149","Rutherford County, Tennessee",121944,2811,119372,2972,106707,3093,1391,612,117981,3048,12665,1868,2572,1114
"678","47155","Sevier County, Tennessee",36670,1823,34179,1843,25472,1982,885,526,33294,1820,8707,1614,2491,865
"679","47157","Shelby County, Tennessee",366593,3470,347451,4250,269595,5433,7578,1537,339873,4226,77856,4990,19142,2416
"680","47163","Sullivan County, Tennessee",68804,1764,62841,2009,50645,2223,3518,992,59323,2089,12196,1618,5963,1362
"681","47165","Sumner County, Tennessee",77760,1378,75264,1567,64958,2358,2140,826,73124,1722,10306,1754,2496,813
"682","47179","Washington County, Tennessee",56752,1521,53622,1808,44994,2202,1435,598,52187,1826,8628,1629,3130,964
"683","47187","Williamson County, Tennessee",91406,1418,90121,1590,84442,2308,1190,453,88931,1693,5679,1438,1285,627
"684","47189","Wilson County, Tennessee",55047,1881,53037,2004,45082,2375,1486,617,51551,1959,7955,1754,2010,671
"685","48005","Angelina County, Texas",32538,1124,30365,1222,22349,1866,788,365,29577,1244,8016,1564,2173,813
"686","48021","Bastrop County, Texas",36341,1005,34843,1494,30932,1823,1493,958,33350,1716,3911,1252,1498,1009
"687","48027","Bell County, Texas",139582,2553,134214,2993,116979,3579,3961,1233,130253,3042,17235,2291,5368,1357
"688","48029","Bexar County, Texas",742836,5255,715438,5623,595135,7386,14141,1931,701297,6128,120303,5726,27398,2994
"689","48037","Bowie County, Texas",34038,1612,29705,1918,24186,1885,1835,805,27870,1911,5519,1125,4333,1027
"690","48039","Brazoria County, Texas",130734,3172,127040,3152,112449,3850,1594,648,125446,3075,14591,2274,3694,1072
"691","48041","Brazos County, Texas",86154,2809,83083,2963,72164,3205,1206,548,81877,3051,10919,2153,3071,1070
"692","48061","Cameron County, Texas",135734,2525,121285,3089,93881,3750,1676,597,119609,3126,27404,3161,14449,1964
"693","48085","Collin County, Texas",399810,3083,395156,3406,369381,4714,4712,1201,390444,3517,25775,3697,4654,1353
"694","48091","Comal County, Texas",67392,2065,66125,2145,58039,2380,1539,950,64586,2222,8086,2116,1267,617
"695","48099","Coryell County, Texas",26980,1258,26128,1228,21757,1409,728,462,25400,1329,4371,962,852,401
"696","48113","Dallas County, Texas",975062,5240,935800,6267,780423,8405,21872,2562,913928,6282,155377,6957,39262,4021
"697","48121","Denton County, Texas",350081,2701,345582,3010,318010,4801,3857,1026,341725,3036,27572,4080,4499,1487
"698","48135","Ector County, Texas",64169,1300,62054,1665,44699,3404,1384,1010,60670,1996,17355,3359,2115,1061
"699","48139","Ellis County, Texas",69223,1100,67175,1365,59519,2084,1789,783,65386,1582,7656,1627,2048,768
"700","48141","El Paso County, Texas",298059,2463,281165,2988,223437,4119,7359,1480,273806,3377,57728,4149,16894,2071
"701","48157","Fort Bend County, Texas",283446,2639,276486,3335,257751,4569,5780,1865,270706,3544,18735,3575,6960,1915
"702","48167","Galveston County, Texas",144182,2100,140186,2454,120897,3477,3470,1470,136716,2992,19289,2811,3996,1285
"703","48181","Grayson County, Texas",56005,1576,53118,1757,42162,2330,1428,675,51690,1878,10956,1838,2887,766
"704","48183","Gregg County, Texas",46766,1743,44432,1731,33316,1981,926,494,43506,1845,11116,1610,2334,806
"705","48187","Guadalupe County, Texas",61414,1664,59197,1696,50445,1894,1911,828,57286,1800,8752,1613,2217,810
"706","48201","Harris County, Texas",1735020,9139,1680593,10669,1358563,11972,34136,4241,1646457,11363,322030,11740,54427,4958
"707","48203","Harrison County, Texas",25866,1133,24384,1230,19522,1676,861,490,23523,1286,4862,1195,1482,735
"708","48209","Hays County, Texas",94205,1915,89421,2692,81235,3334,1187,512,88234,2736,8186,2500,4784,1660
"709","48213","Henderson County, Texas",32576,1700,29368,1766,21498,1987,1152,612,28216,1809,7870,1412,3208,1002
"710","48215","Hidalgo County, Texas",268598,4114,251063,4695,178031,6266,2867,968,248196,4754,73032,5844,17535,2414
"711","48231","Hunt County, Texas",37206,1435,34659,1750,28017,2131,821,560,33838,1924,6642,1389,2547,902
"712","48245","Jefferson County, Texas",94828,2532,91498,2596,64543,3085,1984,695,89514,2695,26955,3243,3330,890
"713","48251","Johnson County, Texas",64338,1659,61932,1795,53055,2165,1580,549,60352,1870,8877,1447,2406,984
"714","48257","Kaufman County, Texas",50212,959,48589,1166,39638,1913,1182,591,47407,1298,8951,1818,1623,676
"715","48291","Liberty County, Texas",29290,1675,27761,1722,19516,2130,597,513,27164,1814,8245,1947,1529,760
"716","48303","Lubbock County, Texas",124689,2412,119936,2722,93971,3444,1531,665,118405,2798,25965,3179,4753,1286
"717","48309","McLennan County, Texas",97065,2170,94226,2090,75821,3155,2511,682,91715,2201,18405,2438,2839,801
"718","48329","Midland County, Texas",66052,1696,63953,1936,49543,3690,832,594,63121,1989,14410,3406,2099,1033
"719","48339","Montgomery County, Texas",232095,4238,227340,4378,195870,5894,3819,1676,223521,4570,31470,4718,4755,1307
"720","48355","Nueces County, Texas",127624,2691,120167,2880,92359,3681,3347,1135,116820,3040,27808,2981,7457,1531
"721","48361","Orange County, Texas",31323,1376,30151,1513,22894,1504,1089,475,29062,1676,7257,1366,1172,639
"722","48367","Parker County, Texas",55525,1388,53880,1580,45604,2235,1027,576,52853,1555,8276,1693,1645,795
"723","48375","Potter County, Texas",44472,2044,41572,2196,28558,2764,886,526,40686,2256,13014,1906,2900,787
"724","48381","Randall County, Texas",56509,1458,55002,1498,47050,1931,1691,779,53311,1728,7952,1379,1507,638
"725","48397","Rockwall County, Texas",39329,1040,38844,1134,35944,1317,861,671,37983,1394,2900,1032,485,500
"726","48409","San Patricio County, Texas",25495,1228,23200,1363,18994,1370,616,302,22584,1410,4206,1183,2295,815
"727","48423","Smith County, Texas",81175,2440,78223,2670,59858,3125,1852,607,76371,2761,18365,2670,2952,904
"728","48427","Starr County, Texas",19460,895,17528,1048,12332,1172,241,237,17287,1033,5196,1068,1932,490
"729","48439","Tarrant County, Texas",771657,5146,747902,5528,635059,8251,12569,1894,735333,6038,112843,6781,23755,3048
"730","48441","Taylor County, Texas",55974,1458,51569,1929,42114,2310,1165,509,50404,1974,9455,1418,4405,1190
"731","48451","Tom Green County, Texas",45516,1868,43291,2132,35825,2250,1513,669,41778,2161,7466,1617,2225,887
"732","48453","Travis County, Texas",567627,5754,555519,6093,507220,8176,9274,1886,546245,6437,48299,6277,12108,2738
"733","48469","Victoria County, Texas",36753,1054,34789,1227,23825,1730,287,198,34502,1238,10964,1799,1964,671
"734","48471","Walker County, Texas",24704,2989,23996,2962,19173,2546,257,241,23739,2924,4823,1830,708,538
"735","48479","Webb County, Texas",78730,1303,75214,1542,52838,2420,1316,746,73898,1753,22376,2223,3516,886
"736","48485","Wichita County, Texas",49071,1648,45422,1921,36295,1934,1785,674,43637,1886,9127,1448,3649,985
"737","48491","Williamson County, Texas",241836,2107,239933,2172,218639,3805,6651,1737,233282,2714,21294,3300,1903,581
"738","48497","Wise County, Texas",24449,968,23851,1076,19277,1479,488,321,23363,1053,4574,1274,598,371
"739","49005","Cache County, Utah",43099,1008,42123,1057,39619,1416,951,514,41172,1092,2504,988,976,383
"740","49011","Davis County, Utah",114119,1538,111016,1697,102507,1968,2470,909,108546,2003,8509,1788,3103,836
"741","49035","Salt Lake County, Utah",420303,3529,411587,3615,371303,5206,7609,1657,403978,3907,40284,3603,8716,1537
"742","49045","Tooele County, Utah",23495,420,22757,675,20263,862,355,311,22402,723,2494,792,738,568
"743","49049","Utah County, Utah",194258,1592,192934,1591,184023,1713,2809,711,190125,1760,8911,1507,1324,477
"744","49053","Washington County, Utah",68090,2218,65483,2582,59256,2584,1994,720,63489,2685,6227,1515,2607,1254
"745","49057","Weber County, Utah",92869,1519,89955,1723,82304,1889,1449,522,88506,1779,7651,1201,2914,909
"746","50007","Chittenden County, Vermont",70730,1270,68874,1406,62755,1551,1188,437,67686,1475,6119,1427,1856,784
"747","51003","Albemarle County, Virginia",45195,1636,43211,1721,38862,1875,1047,440,42164,1785,4349,1329,1984,748
"748","51013","Arlington County, Virginia",108396,2209,106292,2400,101025,2503,1580,535,104712,2447,5267,1203,2104,901
"749","51015","Augusta County, Virginia",30186,1135,27506,1484,22001,1396,930,478,26576,1510,5505,1202,2680,1041
"750","51019","Bedford County, Virginia",33397,1044,32077,1161,26256,1495,998,391,31079,1241,5821,1314,1320,512
"751","51041","Chesterfield County, Virginia",136070,1641,131769,1850,119770,2427,3189,744,128580,1864,11999,1989,4301,1145
"752","51059","Fairfax County, Virginia",410660,2562,402477,2929,383280,3734,6965,1110,395512,3098,19197,2481,8183,1687
"753","51061","Fauquier County, Virginia",26887,780,26220,860,22083,1276,1214,539,25006,1027,4137,1167,667,377
"754","51069","Frederick County, Virginia",34581,1045,33171,1274,28031,1477,895,389,32276,1328,5140,1328,1410,659
"755","51085","Hanover County, Virginia",42274,1093,40756,1211,36278,1492,1301,492,39455,1378,4478,1190,1518,575
"756","51087","Henrico County, Virginia",137035,1483,130503,1716,113240,2647,4067,1025,126436,1923,17263,2280,6532,1268
"757","51095","James City County, Virginia",31060,1203,29782,1374,27450,1574,874,396,28908,1446,2332,819,1278,522
"758","51107","Loudoun County, Virginia",141935,782,140480,1081,135661,1639,2776,770,137704,1307,4819,1333,1455,663
"759","51121","Montgomery County, Virginia",37796,1734,36734,1827,32410,2212,1107,657,35627,1960,4324,1238,1062,478
"760","51153","Prince William County, Virginia",154619,1652,152110,1793,141170,2624,2252,766,149858,1909,10940,2159,2509,833
"761","51161","Roanoke County, Virginia",39093,1231,36917,1423,31211,1702,1377,531,35540,1481,5706,1296,2176,782
"762","51165","Rockingham County, Virginia",32551,985,28886,1305,23718,1408,721,390,28165,1345,5168,930,3665,980
"763","51177","Spotsylvania County, Virginia",51179,1016,50299,1085,45712,1574,1857,659,48442,1294,4587,1292,880,419
"764","51179","Stafford County, Virginia",51007,1331,50023,1311,45597,1731,670,425,49353,1346,4426,1209,984,538
"765","51199","York County, Virginia",26641,780,25842,1005,23923,1244,913,537,24929,968,1919,692,799,660
"766","51510","Alexandria city, Virginia",72024,2137,70315,2131,63397,2325,1254,610,69061,2344,6918,1365,1709,716
"767","51550","Chesapeake city, Virginia",93849,1160,90685,1389,81129,2130,1873,683,88812,1614,9556,1818,3164,966
"768","51650","Hampton city, Virginia",58181,1422,56199,1603,47051,2178,1854,623,54345,1753,9148,1600,1982,806
"769","51680","Lynchburg city, Virginia",28346,1501,26654,1560,22737,1700,956,474,25698,1623,3917,957,1692,533
"770","51700","Newport News city, Virginia",77489,1658,74739,1721,62702,2318,2157,709,72582,1928,12037,1981,2750,904
"771","51710","Norfolk city, Virginia",97596,2128,92788,2190,77129,2920,1668,509,91120,2230,15659,2283,4808,993
"772","51740","Portsmouth city, Virginia",40827,1082,38264,1366,30491,1718,1339,617,36925,1412,7773,1640,2563,938
"773","51760","Richmond city, Virginia",99929,2577,93792,2943,80358,2951,2337,873,91455,3149,13434,2112,6137,1506
"774","51770","Roanoke city, Virginia",42455,1881,39530,1863,29810,1737,2139,724,37391,1919,9720,1537,2925,691
"775","51800","Suffolk city, Virginia",37383,994,35901,1144,31735,1289,916,365,34985,1179,4166,910,1482,594
"776","51810","Virginia Beach city, Virginia",182775,1901,178165,1883,159581,3171,4691,1063,173474,1929,18584,2483,4610,1028
"777","53005","Benton County, Washington",76855,1547,73571,1700,62860,2308,2736,930,70835,1893,10711,1911,3284,1124
"778","53007","Chelan County, Washington",32050,1472,30800,1495,24938,1872,1611,680,29189,1679,5862,1358,1250,535
"779","53009","Clallam County, Washington",34773,1072,33844,1136,28699,1335,2037,552,31807,1201,5145,1113,929,387
"780","53011","Clark County, Washington",193919,1560,188346,1978,167778,3060,5736,1249,182610,2218,20568,2518,5573,1265
"781","53015","Cowlitz County, Washington",43204,1061,41074,1261,34926,1871,1879,629,39195,1399,6148,1401,2130,612
"782","53021","Franklin County, Washington",28989,825,28127,1033,22469,1612,466,440,27661,1163,5658,1573,862,613
"783","53025","Grant County, Washington",35572,1153,33752,1424,25879,2062,1025,533,32727,1483,7873,1900,1820,773
"784","53027","Grays Harbor County, Washington",30500,1360,28349,1566,22612,1566,1188,463,27161,1605,5737,1371,2151,740
"785","53029","Island County, Washington",35976,1894,34992,1966,32040,2064,1784,588,33208,2069,2952,790,984,432
"786","53033","King County, Washington",924763,5641,905591,5966,835945,6838,17501,2235,888090,5992,69646,4640,19172,2375
"787","53035","Kitsap County, Washington",106399,1838,104211,2079,94942,2567,2894,678,101317,2198,9269,1387,2188,799
"788","53041","Lewis County, Washington",32304,1138,30680,1103,25581,1476,1996,563,28684,1230,5099,1092,1624,492
"789","53045","Mason County, Washington",25036,1862,23348,1777,20429,1597,1823,757,21525,1966,2919,933,1688,636
"790","53053","Pierce County, Washington",347668,2988,337882,3311,302117,3752,8798,1450,329084,3237,35765,2947,9786,1891
"791","53057","Skagit County, Washington",51971,1015,49770,1140,43240,1606,1994,530,47776,1243,6530,1377,2201,645
"792","53061","Snohomish County, Washington",312365,2487,304571,2815,281331,4088,7727,1400,296844,3065,23240,2735,7794,1636
"793","53063","Spokane County, Washington",217920,2165,209695,2522,183000,3379,6107,1046,203588,2823,26695,2816,8225,1500
"794","53067","Thurston County, Washington",117186,1700,113996,2010,104895,2718,4038,1100,109958,2262,9101,1949,3190,1026
"795","53073","Whatcom County, Washington",92219,1978,89404,2175,81238,2535,2336,655,87068,2298,8166,1721,2815,1083
"796","53077","Yakima County, Washington",86992,1337,81153,1754,61044,2579,2056,532,79097,1892,20109,2792,5839,1285
"797","54003","Berkeley County, West Virginia",50841,966,48870,1247,40867,1846,1576,742,47294,1431,8003,1640,1971,666
"798","54011","Cabell County, West Virginia",39631,1735,36799,1779,29340,2175,1163,590,35636,1848,7459,1395,2832,794
"799","54033","Harrison County, West Virginia",26143,1103,23968,1336,19517,1467,562,270,23406,1321,4451,876,2175,633
"800","54039","Kanawha County, West Virginia",77634,2094,72604,2354,56209,2958,2566,714,70038,2361,16395,2336,5030,1322
"801","54061","Monongalia County, West Virginia",42710,1616,40865,1741,37211,1827,1364,528,39501,1826,3654,876,1845,556
"802","54081","Raleigh County, West Virginia",29505,1202,25292,1483,19715,1506,639,386,24653,1483,5577,1190,4213,1068
"803","54107","Wood County, West Virginia",35756,1293,33151,1275,26589,1773,1761,577,31390,1439,6562,1286,2605,753
"804","55009","Brown County, Wisconsin",110225,1451,105004,1736,92741,2222,3443,801,101561,1908,12263,1849,5221,1188
"805","55017","Chippewa County, Wisconsin",26791,730,24724,833,19401,1236,951,335,23773,826,5323,1081,2067,551
"806","55025","Dane County, Wisconsin",243924,2428,237984,2907,219651,3680,5907,976,232077,3122,18333,2309,5940,1237
"807","55027","Dodge County, Wisconsin",36286,829,33937,978,28091,1185,1584,474,32353,1121,5846,863,2349,529
"808","55035","Eau Claire County, Wisconsin",43253,1063,41175,1226,35203,1702,1424,498,39751,1343,5972,1246,2078,490
"809","55039","Fond du Lac County, Wisconsin",42758,1043,40104,1076,33060,1213,1329,433,38775,1186,7044,1168,2654,701
"810","55055","Jefferson County, Wisconsin",35088,814,32773,1051,28655,1093,1341,508,31432,1083,4118,713,2315,700
"811","55059","Kenosha County, Wisconsin",67810,1359,65273,1498,56445,2151,2152,649,63121,1527,8828,1602,2537,740
"812","55063","La Crosse County, Wisconsin",50217,1202,47429,1366,40422,1777,1179,418,46250,1327,7007,1488,2788,758
"813","55071","Manitowoc County, Wisconsin",35716,889,31927,1267,25711,1587,1741,452,30186,1193,6216,1063,3789,1245
"814","55073","Marathon County, Wisconsin",57566,838,54227,1186,47187,1601,2338,711,51889,1262,7040,1109,3339,707
"815","55079","Milwaukee County, Wisconsin",389434,3062,365488,3469,295642,4018,11686,1568,353802,3647,69846,3407,23946,2255
"816","55087","Outagamie County, Wisconsin",77071,1238,73608,1421,62946,1663,2667,770,70941,1582,10662,1354,3463,774
"817","55089","Ozaukee County, Wisconsin",36144,1223,34482,1370,31142,1472,1357,477,33125,1370,3340,868,1662,487
"818","55097","Portage County, Wisconsin",29937,548,28358,680,23916,1015,1051,343,27307,734,4442,906,1579,428
"819","55101","Racine County, Wisconsin",79068,1427,74449,1641,62724,2251,2963,717,71486,1730,11725,2021,4619,1059
"820","55105","Rock County, Wisconsin",67876,1169,64405,1472,53873,1901,2472,648,61933,1517,10532,1559,3471,808
"821","55109","St. Croix County, Wisconsin",36873,729,35883,810,31133,1362,1524,602,34359,974,4750,1091,990,345
"822","55111","Sauk County, Wisconsin",27524,938,25862,1030,21933,1168,1423,452,24439,1066,3929,981,1662,443
"823","55117","Sheboygan County, Wisconsin",49416,903,46305,1086,39150,1603,1903,612,44402,1166,7155,1138,3111,647
"824","55127","Walworth County, Wisconsin",43086,1524,40793,1617,34450,1747,1587,491,39206,1621,6343,1161,2293,771
"825","55131","Washington County, Wisconsin",56636,982,53987,1331,47643,1690,1703,554,52284,1281,6344,1319,2649,768
"826","55133","Waukesha County, Wisconsin",167089,1527,161242,1898,149068,2193,5167,847,156075,2107,12174,1819,5847,1006
"827","55139","Winnebago County, Wisconsin",72794,1154,69935,1360,60228,1714,2953,823,66982,1467,9707,1409,2859,671
"828","55141","Wood County, Wisconsin",31890,976,29784,1189,23953,1257,1379,343,28405,1174,5831,1026,2106,632
"829","56021","Laramie County, Wyoming",43728,654,41349,1169,36088,1583,1233,443,40116,1277,5261,1332,2379,963
"830","56025","Natrona County, Wyoming",33203,1266,31597,1316,25245,1670,1021,394,30576,1288,6352,1461,1606,603
"831","72013","Arecibo Municipio, Puerto Rico",28742,1774,21923,1661,13781,1573,128,133,21795,1642,8142,1293,6819,1002
"832","72021","Bayamón Municipio, Puerto Rico",66385,1966,58217,2337,38287,2379,3856,939,54361,2613,19930,2051,8168,1271
"833","72025","Caguas Municipio, Puerto Rico",47586,1811,40721,1903,26872,1959,1055,516,39666,1960,13849,1728,6865,1188
"834","72031","Carolina Municipio, Puerto Rico",58930,2634,53845,2622,33057,2523,1034,365,52811,2652,20788,2442,5085,1190
"835","72061","Guaynabo Municipio, Puerto Rico",32826,1342,29814,1411,21546,1550,248,237,29566,1441,8268,1242,3012,818
"836","72097","Mayagüez Municipio, Puerto Rico",27447,1799,23698,1832,13211,1429,419,301,23279,1819,10487,1329,3749,902
"837","72113","Ponce Municipio, Puerto Rico",50007,1956,40965,2145,25335,2304,1222,378,39743,2110,15630,1686,9042,1399
"838","72127","San Juan Municipio, Puerto Rico",135865,3463,107950,3522,73973,3120,9838,1739,98112,3506,33977,2343,27915,2672
"839","72135","Toa Alta Municipio, Puerto Rico",20918,1199,18005,1392,12662,1515,214,214,17791,1395,5343,1251,2913,785
"840","72137","Toa Baja Municipio, Puerto Rico",28276,1461,25997,1646,15036,1518,480,297,25517,1666,10961,1510,2279,713
"841","72139","Trujillo Alto Municipio, Puerto Rico",24898,1268,23541,1429,15752,1712,623,440,22918,1439,7789,1460,1357,635
