"","GEOID","NAME","B28010_001E","B28010_001M","B28010_002E","B28010_002M","B28010_003E","B28010_003M","B28010_004E","B28010_004M","B28010_005E","B28010_005M","B28010_006E","B28010_006M","B28010_007E","B28010_007M"
"1","12071","Lee County, Florida",266266,6274,249205,6169,222885,5936,17044,2152,232161,6289,26320,2622,17061,2496
"2","12073","Leon County, Florida",115193,2769,110378,3026,99428,3480,5664,1222,104714,3133,10950,1854,4815,1034
"3","12081","Manatee County, Florida",144329,3150,133794,3242,117423,3718,10302,1316,123492,3232,16371,1995,10535,1877
"4","12083","Marion County, Florida",140620,3633,123382,3992,107516,4212,10254,1801,113128,3980,15866,2256,17238,2159
"5","12085","Martin County, Florida",62496,2324,58098,2481,50537,2605,3564,852,54534,2616,7561,1317,4398,1158
"6","12086","Miami-Dade County, Florida",872495,7390,793492,7406,659884,8200,26891,2257,766601,7701,133608,5243,79003,4276
"7","12087","Monroe County, Florida",31285,1883,29149,1902,25598,1617,1764,598,27385,1913,3551,1050,2136,777
"8","12089","Nassau County, Florida",31837,1587,30326,1485,27957,1509,2122,814,28204,1486,2369,670,1511,587
"9","12091","Okaloosa County, Florida",79011,2074,73123,2224,62360,2521,3456,805,69667,2189,10763,1994,5888,971
"10","12095","Orange County, Florida",460602,5613,437869,6102,384076,7776,12173,2044,425696,6106,53793,4263,22733,2901
"11","12097","Osceola County, Florida",102385,4041,95329,3784,83557,3966,4178,1044,91151,3757,11772,2115,7056,1679
"12","12099","Palm Beach County, Florida",547824,6969,504971,6733,433584,6424,24834,2172,480137,6609,71387,4357,42853,3202
"13","12101","Pasco County, Florida",207993,3164,190747,3523,172454,3445,14016,1665,176731,3852,18293,1889,17246,2054
"14","12103","Pinellas County, Florida",405807,5631,368306,6036,325207,6316,27558,2542,340748,5980,43099,3516,37501,2990
"15","12105","Polk County, Florida",233058,4313,206797,4325,165452,5242,14829,1735,191968,4131,41345,3765,26261,2386
"16","12107","Putnam County, Florida",29444,1564,24550,1581,19756,1631,3090,823,21460,1526,4794,1016,4894,1037
"17","12109","St. Johns County, Florida",87096,2888,81615,3044,74267,3239,5044,1428,76571,2778,7348,2052,5481,1490
"18","12111","St. Lucie County, Florida",114043,3131,105089,3950,93400,4403,7093,1867,97996,4104,11689,2042,8954,2013
"19","12113","Santa Rosa County, Florida",62216,2354,59320,2454,52319,2828,3422,956,55898,2507,7001,1666,2896,977
"20","12115","Sarasota County, Florida",184614,4152,168164,4956,149941,5066,18958,2520,149206,5090,18223,2631,16450,2372
"21","12117","Seminole County, Florida",176017,2709,168196,2781,156629,3024,4424,903,163772,2609,11567,1745,7821,1198
"22","12119","Sumter County, Florida",55097,2776,51158,2894,45857,2408,5109,1364,46049,3012,5301,1412,3939,1579
"23","12127","Volusia County, Florida",217632,3372,199052,3565,166551,4754,15857,1965,183195,3728,32501,3432,18580,2070
"24","12131","Walton County, Florida",29463,2421,27137,2371,23343,2181,1366,522,25771,2340,3794,949,2326,792
"25","13013","Barrow County, Georgia",26893,625,23932,863,21057,1135,1269,422,22663,813,2875,654,2961,713
"26","13015","Bartow County, Georgia",38765,1030,35841,1499,28824,2164,1909,706,33932,1739,7017,1743,2924,1047
"27","13021","Bibb County, Georgia",56272,1770,50108,1940,39477,2155,3172,871,46936,2182,10631,1841,6164,932
"28","13031","Bulloch County, Georgia",27802,1615,25711,1771,21099,1956,1504,675,24207,1740,4612,1054,2091,887
"29","13045","Carroll County, Georgia",42897,1114,38685,1564,32613,2099,1176,544,37509,1617,6072,1598,4212,1076
"30","13047","Catoosa County, Georgia",25153,967,22815,1208,17668,1604,1683,677,21132,1316,5147,1315,2338,618
"31","13051","Chatham County, Georgia",107754,2203,99953,2481,82255,2443,3215,827,96738,2698,17698,2097,7801,1180
"32","13057","Cherokee County, Georgia",89510,1418,86555,1631,78961,2462,2412,943,84143,1821,7594,1848,2955,798
"33","13059","Clarke County, Georgia",48257,1617,46002,1692,40299,2043,1958,611,44044,1906,5703,1307,2255,684
"34","13063","Clayton County, Georgia",94199,2084,87597,2515,69109,2666,3936,1116,83661,2588,18488,2043,6602,1285
"35","13067","Cobb County, Georgia",277609,3623,268883,3910,243340,4478,7250,1274,261633,4025,25543,3245,8726,1494
"36","13073","Columbia County, Georgia",43990,2227,40898,2272,36332,2335,2950,859,37948,2423,4566,1378,3092,1141
"37","13077","Coweta County, Georgia",52796,998,49760,1157,42530,1782,2050,677,47710,1367,7230,1511,3036,974
"38","13089","DeKalb County, Georgia",278249,3395,261390,4155,219943,4639,6908,1209,254482,4283,41447,3721,16859,2372
"39","13095","Dougherty County, Georgia",34179,1340,29845,1490,22304,1707,2024,610,27821,1514,7541,1423,4334,850
"40","13097","Douglas County, Georgia",49962,1073,47396,1338,41844,1986,1075,464,46321,1434,5552,1661,2566,848
"41","13113","Fayette County, Georgia",40484,851,38586,1117,36461,1376,1519,674,37067,1328,2125,903,1898,780
"42","13115","Floyd County, Georgia",36927,1233,32675,1316,26430,1679,2287,599,30388,1298,6245,1208,4252,999
"43","13117","Forsyth County, Georgia",78299,925,76153,1132,72912,1386,2012,682,74141,1179,3241,933,2146,719
"44","13121","Fulton County, Georgia",410408,5779,382775,6255,337756,6454,10755,1924,372020,6594,45019,4185,27633,2705
"45","13127","Glynn County, Georgia",34380,1833,29595,1906,24592,1922,1399,568,28196,1853,5003,1162,4785,1103
"46","13135","Gwinnett County, Georgia",292679,3132,281633,3294,251099,3759,8689,1635,272944,3402,30534,3440,11046,1962
"47","13139","Hall County, Georgia",62164,1853,57031,2094,47757,2138,2508,628,54523,2149,9274,1308,5133,1164
"48","13151","Henry County, Georgia",77170,1577,73116,2036,65803,2587,2628,938,70488,2319,7313,1577,4054,1067
"49","13153","Houston County, Georgia",56860,2116,53092,2231,43347,2630,2384,801,50708,2313,9745,1993,3768,926
"50","13157","Jackson County, Georgia",23785,852,21332,1022,18550,1290,1062,449,20270,1032,2782,981,2453,775
"51","13185","Lowndes County, Georgia",41585,1515,35829,1708,30847,1977,2613,835,33216,1713,4982,1210,5756,1098
"52","13215","Muscogee County, Georgia",70306,1831,61483,1926,47181,2157,3189,872,58294,2133,14302,1832,8823,1219
"53","13217","Newton County, Georgia",37519,850,33712,1205,30426,1364,1657,679,32055,1311,3286,1436,3807,1044
"54","13223","Paulding County, Georgia",52707,1442,48829,1845,45514,2071,1447,540,47382,1828,3315,1165,3878,1104
"55","13245","Richmond County, Georgia",71411,2564,61940,2963,46310,3357,4257,993,57683,3048,15630,2273,9471,1557
"56","13247","Rockdale County, Georgia",29849,1103,28365,1237,24322,1501,890,320,27475,1251,4043,1314,1484,623
"57","13255","Spalding County, Georgia",25151,997,20800,1562,17384,1582,1766,841,19034,1574,3416,959,4351,1271
"58","13285","Troup County, Georgia",24716,1176,19947,1485,15303,1626,1352,586,18595,1521,4644,1186,4769,1139
"59","13295","Walker County, Georgia",26270,1292,22736,1704,18030,1731,1178,546,21558,1730,4706,1345,3534,1155
"60","13297","Walton County, Georgia",31114,1089,29044,1224,23158,1449,819,376,28225,1294,5886,1383,2070,698
"61","13313","Whitfield County, Georgia",35824,1363,30840,1736,23053,2108,1321,456,29519,1792,7787,1395,4984,1077
"62","15001","Hawaii County, Hawaii",68857,2122,60747,2418,52128,2160,7610,1418,53137,2306,8619,1439,8110,1340
"63","15003","Honolulu County, Hawaii",312625,3402,288365,4085,251839,4393,12427,1520,275938,4020,36526,2758,24260,2568
"64","15007","Kauai County, Hawaii",22980,1082,20440,1128,17178,1129,886,410,19554,1201,3262,744,2540,528
"65","15009","Maui County, Hawaii",53560,1854,48704,2005,42097,2015,2170,549,46534,1922,6607,1253,4856,1172
"66","16001","Ada County, Idaho",171009,2623,154413,3899,143841,3945,11181,2309,143232,4118,10572,1860,16596,2685
"67","16005","Bannock County, Idaho",31384,910,29369,1164,25972,1355,1015,310,28354,1171,3397,1009,2015,624
"68","16019","Bonneville County, Idaho",41118,725,38453,1029,32811,1212,1887,608,36566,1181,5642,1142,2665,769
"69","16027","Canyon County, Idaho",72684,1211,65448,2020,55882,2187,5942,1217,59506,2146,9566,1803,7236,1428
"70","16055","Kootenai County, Idaho",60383,1911,56545,2277,49557,2361,4448,1375,52097,2333,6988,1534,3838,1231
"71","16083","Twin Falls County, Idaho",30845,1022,28884,1084,24989,1502,2958,867,25926,1392,3895,978,1961,601
"72","17001","Adams County, Illinois",27160,805,23824,1011,18703,1203,1315,520,22509,1131,5121,861,3336,785
"73","17019","Champaign County, Illinois",83080,2094,78489,2386,69374,2612,3366,697,75123,2323,9115,1732,4591,1080
"74","17031","Cook County, Illinois",1948373,8743,1749106,9263,1483775,10615,80774,3902,1668332,9349,265331,8120,199267,5835
"75","17037","DeKalb County, Illinois",38324,1032,35235,1223,30587,1701,1683,578,33552,1384,4648,1283,3089,813
"76","17043","DuPage County, Illinois",341845,2595,320241,3195,297609,3657,15292,1495,304949,3082,22632,2068,21604,1759
"77","17089","Kane County, Illinois",180787,2077,170523,2511,151525,3166,7352,1378,163171,2684,18998,2767,10264,1552
"78","17091","Kankakee County, Illinois",39628,1191,33810,1400,28117,1406,2496,741,31314,1426,5693,1029,5818,1028
"79","17093","Kendall County, Illinois",40930,889,38985,1505,35321,1851,1353,714,37632,1660,3664,1140,1945,1231
"80","17097","Lake County, Illinois",247720,2414,233663,3059,211216,3380,9763,1467,223900,3386,22447,2392,14057,1917
"81","17099","LaSalle County, Illinois",44625,1200,40207,1317,34008,1462,2921,561,37286,1388,6199,1209,4418,782
"82","17111","McHenry County, Illinois",112193,1712,107899,1903,98902,2155,5757,1107,102142,2095,8997,1347,4294,1007
"83","17113","McLean County, Illinois",65146,1738,61066,1888,54282,2187,2028,529,59038,1966,6784,1310,4080,842
"84","17115","Macon County, Illinois",42977,1505,38272,1620,30972,1573,2931,737,35341,1659,7300,951,4705,825
"85","17119","Madison County, Illinois",107212,1923,94788,2550,80906,2851,5594,1197,89194,2706,13882,1891,12424,1523
"86","17143","Peoria County, Illinois",71371,1961,63035,2069,49847,2314,3452,730,59583,2073,13188,1655,8336,1228
"87","17161","Rock Island County, Illinois",60438,1471,53616,1995,43847,1997,3444,724,50172,1975,9769,1546,6822,1098
"88","17163","St. Clair County, Illinois",102793,2202,90706,2647,72636,2898,5642,1285,85064,2899,18070,2109,12087,1689
"89","17167","Sangamon County, Illinois",84583,1744,76340,1854,63338,2122,4465,946,71875,2021,13002,1694,8243,1255
"90","24015","Cecil County, Maryland",36397,1507,33762,1642,30210,1633,2314,678,31448,1661,3552,951,2635,831
"91","24017","Charles County, Maryland",56608,1077,51944,1329,46565,1667,2425,654,49519,1502,5379,1256,4664,817
"92","24021","Frederick County, Maryland",92329,1408,87580,1647,81002,1926,4714,943,82866,1615,6578,1192,4749,1002
"93","24025","Harford County, Maryland",93705,1456,87353,1629,80070,1847,4468,751,82885,1733,7283,1308,6352,984
"94","24027","Howard County, Maryland",115289,1695,111785,1932,105294,2506,2817,769,108968,2052,6491,1811,3504,1009
"95","24031","Montgomery County, Maryland",373219,2431,360440,2898,336495,3980,15293,1549,345147,3387,23945,2479,12779,1545
"96","24033","Prince George's County, Maryland",310730,2413,293371,3235,254933,3927,14103,1452,279268,3566,38438,3213,17359,2041
"97","24037","St. Mary's County, Maryland",40820,1443,37350,1812,35042,1867,2456,898,34894,1868,2308,753,3470,1096
"98","24043","Washington County, Maryland",56663,1259,48992,1628,40828,1850,3156,813,45836,1496,8164,1262,7671,1200
"99","24045","Wicomico County, Maryland",37665,1149,34233,1521,29152,1485,2715,704,31518,1588,5081,1152,3432,930
"100","24510","Baltimore city, Maryland",240280,3634,207922,4247,161040,4242,10411,1544,197511,4382,46882,3509,32358,2639
"101","25001","Barnstable County, Massachusetts",92148,3008,86368,2917,77961,2458,7715,1350,78653,3259,8407,1668,5780,1159
"102","25003","Berkshire County, Massachusetts",54193,1636,48582,1779,42351,1800,5880,1095,42702,1958,6231,1222,5611,1031
"103","25005","Bristol County, Massachusetts",218570,2828,192803,3238,161424,3780,13813,1601,178990,3628,31379,3113,25767,2448
"104","25009","Essex County, Massachusetts",294092,2740,266671,3565,230243,4205,15158,1705,251513,3473,36428,2973,27421,2957
"105","25011","Franklin County, Massachusetts",29239,952,26062,1061,23375,1075,2831,657,23231,1145,2687,754,3177,681
"106","25013","Hampden County, Massachusetts",180933,1783,153921,2702,126041,3655,11835,1786,142086,3089,27880,2794,27012,1924
"107","25015","Hampshire County, Massachusetts",57848,1800,54763,1930,50860,1996,5600,883,49163,2066,3903,894,3085,723
"108","25017","Middlesex County, Massachusetts",599499,3901,554515,4254,519192,5159,27614,2172,526901,4808,35323,3089,44984,2967
"109","25021","Norfolk County, Massachusetts",263862,2627,247494,3046,230983,4017,14632,1950,232862,2929,16511,2584,16368,1559
"110","25023","Plymouth County, Massachusetts",187608,3032,175357,3364,154963,3489,10187,1646,165170,3487,20394,2514,12251,1955
"111","25025","Suffolk County, Massachusetts",308889,3403,282070,4564,242403,5188,11649,1779,270421,4628,39667,3026,26819,2558
"112","25027","Worcester County, Massachusetts",308533,3215,278782,3662,246403,4395,18938,2290,259844,3779,32379,2787,29751,2331
"113","26005","Allegan County, Michigan",44766,1071,39723,1368,33108,1678,2572,633,37151,1424,6615,1178,5043,971
"114","26017","Bay County, Michigan",44907,1067,38305,1343,29559,1710,2516,670,35789,1385,8746,1379,6602,1007
"115","26021","Berrien County, Michigan",64166,1763,57847,1869,47324,2030,4048,888,53799,1914,10523,1333,6319,1039
"116","26025","Calhoun County, Michigan",54556,1354,47856,1555,38099,2048,4972,890,42884,1587,9757,1363,6700,1027
"117","26037","Clinton County, Michigan",29959,760,27215,1079,23333,1204,1861,484,25354,1086,3882,825,2744,663
"118","26045","Eaton County, Michigan",44329,796,41113,904,35443,1464,2665,785,38448,1139,5670,1112,3216,644
"119","26049","Genesee County, Michigan",165719,2865,142806,3220,117237,3545,10521,1325,132285,3377,25569,2532,22913,2342
"120","26055","Grand Traverse County, Michigan",38211,1692,35555,1698,30747,2044,1718,572,33837,1697,4808,1148,2656,610
"121","26065","Ingham County, Michigan",111915,1765,103936,2139,89241,2820,5035,957,98901,2234,14695,2347,7979,1300
"122","26073","Isabella County, Michigan",25000,958,23031,999,19256,1191,1108,307,21923,1023,3775,685,1969,449
"123","26075","Jackson County, Michigan",62220,1324,57041,1499,46854,1613,4713,827,52328,1686,10187,1296,5179,1025
"124","26077","Kalamazoo County, Michigan",104075,2038,96711,2273,85583,2543,5729,833,90982,2289,11128,1752,7364,1166
"125","26081","Kent County, Michigan",240678,2686,221431,3676,195799,3643,11014,1321,210417,3813,25632,2362,19247,2243
"126","26087","Lapeer County, Michigan",34271,848,31010,1048,26582,1193,2131,556,28879,1036,4428,759,3261,741
"127","26091","Lenawee County, Michigan",38559,1367,35246,1314,28063,1322,2258,495,32988,1416,7183,1206,3313,636
"128","26093","Livingston County, Michigan",72726,1027,69451,1283,62850,1394,3734,720,65717,1351,6601,977,3275,779
"129","26099","Macomb County, Michigan",346457,2849,315591,3494,271108,4211,21284,1913,294307,3726,44483,3324,30866,2224
"130","26103","Marquette County, Michigan",25725,1127,23247,1176,19962,1133,1768,453,21479,1233,3285,662,2478,449
"131","26111","Midland County, Michigan",34096,960,30913,1002,26795,1139,1549,470,29364,1059,4118,889,3183,638
"132","26115","Monroe County, Michigan",59528,1330,52876,1696,44700,1828,3917,874,48959,1935,8176,1334,6652,1188
"133","26121","Muskegon County, Michigan",64581,1572,56964,1944,47006,2066,5176,1145,51788,2184,9958,1409,7617,1117
"134","26125","Oakland County, Michigan",504944,3257,475606,3889,431893,4627,22356,1916,453250,4171,43713,3344,29338,2176
"135","26139","Ottawa County, Michigan",104281,1341,95864,1837,87340,2082,4196,847,91668,2025,8524,1321,8417,1529
"136","26145","Saginaw County, Michigan",80958,1412,70197,2132,55476,1869,5077,948,65120,2196,14721,1529,10761,1599
"137","26147","St. Clair County, Michigan",65117,1530,59122,1807,47892,1979,4042,751,55080,1950,11230,1585,5995,961
"138","26155","Shiawassee County, Michigan",27277,902,24035,1092,19960,1292,2130,582,21905,1147,4075,779,3242,764
"139","26159","Van Buren County, Michigan",29037,1207,26475,1282,21778,1247,1533,458,24942,1301,4697,874,2562,479
"140","26161","Washtenaw County, Michigan",140729,1922,133594,2201,122571,2566,6285,986,127309,2251,11023,1264,7135,1206
"141","26163","Wayne County, Michigan",683986,5594,602549,6132,474141,7189,32166,2279,570383,6124,128408,4959,81437,3703
"142","27003","Anoka County, Minnesota",127305,1201,118897,1854,107871,2236,7276,1161,111621,2034,11026,1667,8408,1265
"143","27013","Blue Earth County, Minnesota",26098,889,24252,974,22064,1089,2019,700,22233,968,2188,571,1846,425
"144","27019","Carver County, Minnesota",35721,1048,34450,1116,32910,1225,1412,428,33038,1234,1540,384,1271,377
"145","27037","Dakota County, Minnesota",160590,1375,152373,1925,139605,2104,7191,1116,145182,2323,12768,1803,8217,1215
"146","27053","Hennepin County, Minnesota",507728,3356,477306,4003,435605,4901,25712,2289,451594,4238,41701,3554,30422,2927
"147","27109","Olmsted County, Minnesota",61873,1343,58225,1487,53847,1535,3506,774,54719,1661,4378,922,3648,776
"148","27123","Ramsey County, Minnesota",211123,2185,196174,2252,170928,3262,11668,1363,184506,2458,25246,2472,14949,1693
"149","27131","Rice County, Minnesota",23130,844,21027,964,17860,1193,1789,621,19238,1012,3167,848,2103,531
"150","27137","St. Louis County, Minnesota",85213,1610,75977,1958,63805,2238,5433,778,70544,1842,12172,1468,9236,1202
"151","27139","Scott County, Minnesota",50018,622,47034,768,43978,1116,2496,842,44538,1071,3056,842,2984,672
"152","27141","Sherburne County, Minnesota",31869,965,30072,1034,26890,1290,1479,543,28593,1066,3182,931,1797,582
"153","27145","Stearns County, Minnesota",59708,1098,55227,1432,48753,1862,3858,899,51369,1600,6474,1177,4481,797
"154","27163","Washington County, Minnesota",92337,1678,89317,1890,83044,1967,3469,911,85848,2036,6273,1014,3020,897
"155","27171","Wright County, Minnesota",47868,947,44447,1205,40429,1325,2344,624,42103,1264,4018,880,3421,821
"156","28033","DeSoto County, Mississippi",61764,1429,57832,1566,48241,1903,2804,757,55028,1698,9591,1637,3932,1016
"157","28035","Forrest County, Mississippi",28066,1386,25239,1578,18773,1909,1276,641,23963,1584,6466,1335,2827,722
"158","28047","Harrison County, Mississippi",78449,2380,69130,2848,54641,3320,3473,1076,65657,2948,14489,2172,9319,1730
"159","28049","Hinds County, Mississippi",89570,2221,77910,2649,54461,2751,3221,649,74689,2708,23449,2315,11660,1621
"160","28059","Jackson County, Mississippi",52318,2088,47433,2335,38468,2616,1973,695,45460,2240,8965,2011,4885,1200
"161","28067","Jones County, Mississippi",23950,1598,18357,1746,12747,1696,755,442,17602,1723,5610,1349,5593,1218
"162","28075","Lauderdale County, Mississippi",30019,1417,25222,1728,19832,1777,1907,781,23315,1857,5390,1152,4797,1101
"163","28081","Lee County, Mississippi",30844,1320,26262,1539,18448,1379,1316,547,24946,1572,7814,1150,4582,1092
"164","28089","Madison County, Mississippi",40539,1113,37628,1312,30966,1680,1404,555,36224,1449,6662,1718,2911,794
"165","28121","Rankin County, Mississippi",54699,2011,51380,2093,43235,2191,2548,943,48832,2210,8145,1677,3319,795
"166","29019","Boone County, Missouri",70355,1728,65265,2044,57889,2496,2757,762,62508,2033,7376,1958,5090,1288
"167","29021","Buchanan County, Missouri",33716,1588,26569,1752,21579,1599,1529,518,25040,1771,4990,949,7147,1217
"168","29031","Cape Girardeau County, Missouri",29245,1264,26375,1296,22205,1375,1608,678,24767,1345,4170,956,2870,859
"169","29037","Cass County, Missouri",40545,644,37661,1047,30381,1510,1801,591,35860,989,7280,1251,2884,784
"170","29043","Christian County, Missouri",32009,902,29415,1143,24212,1422,1511,502,27904,1289,5203,1326,2594,853
"171","29047","Clay County, Missouri",92020,1848,84904,2302,73539,2450,3550,850,81354,2416,11365,2079,7116,1408
"172","29051","Cole County, Missouri",29726,1009,26600,1079,22490,1228,2382,663,24218,1127,4110,1044,3126,727
"173","29071","Franklin County, Missouri",40256,1356,36219,1406,30227,1464,2663,823,33556,1477,5992,1273,4037,766
"174","29077","Greene County, Missouri",120498,2271,110911,2202,94019,2762,5615,1028,105296,2464,16892,1939,9587,1427
"175","29095","Jackson County, Missouri",285887,3405,259233,3794,212777,4570,13538,1723,245695,4066,46456,3292,26654,2143
"176","29097","Jasper County, Missouri",46784,1414,41745,1627,32686,2023,2506,804,39239,1599,9059,1561,5039,968
"177","29099","Jefferson County, Missouri",84301,1469,78898,1652,67628,2015,4392,988,74506,1713,11270,1632,5403,1051
"178","29165","Platte County, Missouri",39407,1025,38083,1184,34574,1432,2277,720,35806,1410,3509,971,1324,495
"179","29183","St. Charles County, Missouri",145332,2211,139721,2307,129778,2633,7011,1081,132710,2418,9943,1608,5611,993
"180","17179","Tazewell County, Illinois",54253,1483,48837,1659,42765,1812,3015,922,45822,1638,6072,1082,5416,950
"181","17183","Vermilion County, Illinois",30241,1213,25086,1536,18570,1417,2027,546,23059,1406,6516,1189,5155,909
"182","17197","Will County, Illinois",228366,2621,215346,3084,193331,3086,8559,1228,206787,3444,22015,2113,13020,1651
"183","17199","Williamson County, Illinois",26845,1315,22013,1566,17163,1633,1599,435,20414,1526,4850,893,4832,1068
"184","17201","Winnebago County, Illinois",113789,2013,103931,2328,85913,2420,6550,1015,97381,2282,18018,1534,9858,1284
"185","18003","Allen County, Indiana",143105,2368,131434,2783,107170,3326,8769,1238,122665,2994,24264,2505,11671,1633
"186","18005","Bartholomew County, Indiana",31498,1173,28098,1323,24090,1506,1917,679,26181,1388,4008,1083,3400,847
"187","18011","Boone County, Indiana",25699,744,23530,958,21165,1117,1128,452,22402,1110,2365,875,2169,672
"188","18019","Clark County, Indiana",44957,1396,40272,1667,32961,1780,2052,585,38220,1606,7311,1188,4685,945
"189","18035","Delaware County, Indiana",46588,1453,41429,1634,34286,1986,2484,641,38945,1652,7143,1326,5159,978
"190","18039","Elkhart County, Indiana",73363,1396,64762,1521,51587,1994,4717,1058,60045,1722,13175,1853,8601,1162
"191","18043","Floyd County, Indiana",28614,1058,25338,1178,22306,1207,1175,350,24163,1188,3032,766,3276,663
"192","18053","Grant County, Indiana",25878,1360,22819,1356,18015,1408,2155,567,20664,1303,4804,1022,3059,816
"193","18057","Hamilton County, Indiana",118666,2268,115545,2437,109088,2489,3140,957,112405,2558,6457,1476,3121,860
"194","18059","Hancock County, Indiana",29239,511,27278,957,24668,1276,1417,764,25861,1025,2610,1040,1961,796
"195","18063","Hendricks County, Indiana",58285,1380,55320,1727,49446,2208,1985,768,53335,1794,5874,1587,2965,896
"196","18067","Howard County, Indiana",34243,1399,29990,1613,24603,1635,1916,472,28074,1708,5387,1213,4253,846
"197","18081","Johnson County, Indiana",58648,1070,55083,1428,47201,2233,3048,773,52035,1365,7882,1689,3565,989
"198","18085","Kosciusko County, Indiana",30000,1395,27553,1454,22996,1422,2332,585,25221,1563,4557,964,2447,709
"199","18089","Lake County, Indiana",184206,2966,162515,3411,132246,3605,9509,1387,153006,3300,30269,3186,21691,2149
"200","18091","LaPorte County, Indiana",42385,1508,37367,1665,31477,1622,3159,683,34208,1653,5890,1104,5018,941
"201","18095","Madison County, Indiana",50751,1478,44213,1746,35762,2134,3104,665,41109,1809,8451,1449,6538,1071
"202","18097","Marion County, Indiana",369122,3641,319313,4967,267072,5290,16165,2219,303148,5176,52241,3612,49809,4094
"203","18105","Monroe County, Indiana",57047,1605,53170,1799,46505,2063,2513,741,50657,1794,6665,1300,3877,1131
"204","18109","Morgan County, Indiana",26441,737,23028,1159,18340,1543,1806,541,21222,1159,4688,1228,3413,964
"205","18127","Porter County, Indiana",64722,1325,59228,1653,50644,2019,2942,828,56286,1767,8584,1578,5494,1257
"206","18141","St. Joseph County, Indiana",98705,2519,84906,2803,75466,2666,12476,1751,72430,2924,9440,1285,13799,1310
"207","18157","Tippecanoe County, Indiana",69502,1763,66371,2063,58754,2219,3317,1036,63054,2016,7617,1603,3131,810
"208","18163","Vanderburgh County, Indiana",77174,1582,67921,1988,54973,2384,3792,764,64129,2108,12948,2057,9253,1326
"209","18167","Vigo County, Indiana",41933,1490,36844,1608,29892,1735,2896,799,33948,1621,6952,1158,5089,1042
"210","18177","Wayne County, Indiana",26521,1088,23165,1328,18676,1364,2150,700,21015,1427,4489,1056,3356,764
"211","19013","Black Hawk County, Iowa",52928,1125,47311,1483,41039,1725,3660,752,43651,1506,6272,1128,5617,1074
"212","19049","Dallas County, Iowa",34197,1149,32286,1255,29904,1420,1200,465,31086,1384,2382,766,1911,667
"213","19061","Dubuque County, Iowa",37785,966,34461,1229,29907,1327,2235,594,32226,1389,4554,816,3324,737
"214","19103","Johnson County, Iowa",59190,1546,56714,1627,53291,1907,2927,846,53787,1707,3423,999,2476,705
"215","19113","Linn County, Iowa",89183,1953,82944,2203,73309,2267,5602,1057,77342,2404,9635,1585,6239,1230
"216","19153","Polk County, Iowa",186777,2360,173214,2712,150041,3266,9286,1520,163928,3108,23173,2536,13563,2032
"217","19155","Pottawattamie County, Iowa",36662,991,32340,1437,26858,1568,2776,596,29564,1509,5482,852,4322,914
"218","19163","Scott County, Iowa",64251,1693,57127,1811,49223,1910,3476,668,53651,1806,7904,1321,7124,1291
"219","19169","Story County, Iowa",37689,1211,35427,1350,33092,1416,2088,645,33339,1399,2335,774,2262,1001
"220","19193","Woodbury County, Iowa",39020,1213,35061,1369,27756,1872,2487,708,32574,1436,7305,1373,3959,757
"221","20015","Butler County, Kansas",24385,919,21971,1253,19313,1402,1303,481,20668,1259,2658,778,2414,837
"222","20045","Douglas County, Kansas",47643,1418,45865,1415,42577,1679,2223,612,43642,1492,3288,974,1778,660
"223","20091","Johnson County, Kansas",229030,2177,219319,2658,201786,3177,9844,1314,209475,3077,17533,2388,9711,1451
"224","20103","Leavenworth County, Kansas",27350,1077,25083,1110,21575,1187,1116,467,23967,1148,3508,944,2267,780
"225","20161","Riley County, Kansas",27067,1389,25880,1584,23932,1536,775,352,25105,1618,1948,768,1187,629
"226","20173","Sedgwick County, Kansas",196053,2870,180182,3079,152942,2866,11848,1459,168334,3464,27240,2741,15871,1584
"227","20177","Shawnee County, Kansas",73724,1633,64634,2053,54935,2032,4538,770,60096,2014,9699,1652,9090,1593
"228","20209","Wyandotte County, Kansas",60737,1377,53131,1519,40576,1790,3555,844,49576,1574,12555,1463,7606,1030
"229","21015","Boone County, Kentucky",46388,1225,43904,1440,37612,1758,1991,704,41913,1489,6292,1310,2484,815
"230","21029","Bullitt County, Kentucky",29715,725,26901,875,21872,1352,1451,487,25450,952,5029,1071,2814,753
"231","21037","Campbell County, Kentucky",35740,1488,33312,1510,28614,1585,1872,503,31440,1527,4698,1211,2428,608
"232","21047","Christian County, Kentucky",25584,1236,21967,1428,17423,1522,967,427,21000,1386,4544,1017,3617,871
"233","21059","Daviess County, Kentucky",40920,960,35273,1467,28381,1603,2099,731,33174,1477,6892,1313,5647,1199
"234","21067","Fayette County, Kentucky",129140,2283,121454,2517,105593,2910,4190,931,117264,2647,15861,1786,7686,1371
"235","21093","Hardin County, Kentucky",42911,1212,38723,1487,31199,1898,2036,628,36687,1531,7524,1817,4188,1077
"236","21111","Jefferson County, Kentucky",312747,3307,282838,4015,230531,3992,14305,1590,268533,4164,52307,3404,29909,2408
"237","21117","Kenton County, Kentucky",63679,1401,58719,1451,48997,1700,4140,800,54579,1606,9722,1435,4960,919
"238","21145","McCracken County, Kentucky",26803,1272,23751,1338,19656,1295,1198,441,22553,1380,4095,1057,3052,729
"239","21151","Madison County, Kentucky",33104,1048,30113,1144,24737,1314,782,374,29331,1206,5376,1017,2991,673
"240","21185","Oldham County, Kentucky",20840,637,19782,742,17828,790,690,355,19092,776,1954,598,1058,483
"241","21227","Warren County, Kentucky",47996,1815,43317,1969,36182,2050,1544,561,41773,1981,7135,1431,4679,1101
"242","22005","Ascension Parish, Louisiana",44319,1239,41458,1581,33259,2143,894,484,40564,1560,8199,1866,2861,971
"243","22015","Bossier Parish, Louisiana",49615,1917,45467,1991,37161,2253,2543,754,42924,2034,8306,1677,4148,950
"244","22017","Caddo Parish, Louisiana",95793,2440,80908,2867,61973,2996,4474,965,76434,2922,18935,2200,14885,1808
"245","22019","Calcasieu Parish, Louisiana",78305,2270,68533,2528,54417,3150,3656,1067,64877,2545,14116,2090,9772,1595
"246","22033","East Baton Rouge Parish, Louisiana",162627,3066,144077,3763,117280,4368,6414,1325,137663,3714,26797,3051,18550,2387
"247","22045","Iberia Parish, Louisiana",26345,1063,21861,1383,15542,1437,837,405,21024,1407,6319,1116,4484,939
"248","22051","Jefferson Parish, Louisiana",168031,2032,147613,2957,115875,3704,7069,1224,140544,2943,31738,2805,20418,2053
"249","22055","Lafayette Parish, Louisiana",89465,2670,78050,3094,64285,3049,2495,756,75555,3019,13765,2393,11415,1790
"250","22057","Lafourche Parish, Louisiana",36420,1175,31891,1263,25084,1709,1396,461,30495,1346,6807,1328,4529,963
"251","22063","Livingston Parish, Louisiana",47992,2123,43922,2510,35395,2430,1022,561,42900,2490,8527,1742,4070,1497
"252","22071","Orleans Parish, Louisiana",154560,2853,131298,3247,101194,2937,6491,964,124807,3443,30104,2384,23262,1865
"253","22073","Ouachita Parish, Louisiana",58232,1997,46222,2028,38234,2113,3592,930,42630,2342,7988,1182,12010,1787
"254","22079","Rapides Parish, Louisiana",48473,1800,42010,1940,32132,1963,1993,672,40017,2004,9878,1361,6463,1373
"255","22097","St. Landry Parish, Louisiana",30136,1255,24196,1516,15949,1475,1656,509,22540,1546,8247,1302,5940,1021
"256","22103","St. Tammany Parish, Louisiana",94499,2076,88559,2437,76667,2984,4341,1198,84218,2242,11892,2173,5940,1440
"257","22105","Tangipahoa Parish, Louisiana",49272,1581,42889,2169,31388,2252,1857,719,41032,2130,11501,2235,6383,1496
"258","22109","Terrebonne Parish, Louisiana",40882,1080,35219,1714,26543,1777,1059,576,34160,1781,8676,1632,5663,1440
"259","23001","Androscoggin County, Maine",45979,1233,40283,1642,34981,1850,4806,1024,35477,1679,5302,1274,5696,1213
"260","23003","Aroostook County, Maine",28921,1044,24012,1205,20494,1272,3851,739,20161,1260,3518,726,4909,760
"261","23005","Cumberland County, Maine",117844,2543,107981,2984,96518,3275,6336,1053,101645,3095,11463,1814,9863,1438
"262","23011","Kennebec County, Maine",49616,1470,43207,1866,37629,2139,3291,754,39916,1910,5578,1266,6409,1235
"263","23019","Penobscot County, Maine",60620,1937,54959,1873,46692,2073,5049,939,49910,1795,8267,1377,5661,1056
"264","23031","York County, Maine",82970,2542,77095,2541,69436,2443,6251,1174,70844,2584,7659,1429,5875,1039
"265","24001","Allegany County, Maryland",27177,1413,22404,1643,18272,1535,2123,559,20281,1567,4132,871,4773,1016
"266","24003","Anne Arundel County, Maryland",207950,2666,197688,2933,182863,3524,10761,1811,186927,3371,14825,2288,10262,1658
"267","24005","Baltimore County, Maryland",317106,2712,294373,3405,262703,3719,18482,1823,275891,3611,31670,3045,22733,2216
"268","24009","Calvert County, Maryland",31253,1214,30067,1256,27809,1501,2036,633,28031,1352,2258,858,1186,411
"269","24013","Carroll County, Maryland",61212,1089,56550,1526,51036,1767,3206,772,53344,1607,5514,1190,4662,1004
"270","01003","Baldwin County, Alabama",79120,2586,71177,2962,61018,3146,2024,669,69153,2996,10159,2027,7943,1465
"271","01015","Calhoun County, Alabama",44507,1715,38263,1813,29763,2248,1914,594,36349,1868,8500,1496,6244,1223
"272","01043","Cullman County, Alabama",30740,1568,25269,1562,17985,1701,1446,535,23823,1572,7284,1479,5471,955
"273","01049","DeKalb County, Alabama",25848,1206,20964,1461,16062,1399,1407,603,19557,1503,4902,1016,4884,1106
"274","01051","Elmore County, Alabama",29176,1426,25090,1526,21086,1673,1884,648,23206,1656,4004,1136,4086,1293
"275","01055","Etowah County, Alabama",37091,1718,30595,1785,23410,1715,2837,777,27758,1798,7185,1233,6496,957
"276","01069","Houston County, Alabama",39106,969,32016,1137,25413,1099,3770,659,28246,1201,6603,627,7090,659
"277","01073","Jefferson County, Alabama",259324,4069,229211,4429,184140,4528,10680,1515,218531,4429,45071,3248,30113,2270
"278","01077","Lauderdale County, Alabama",38215,1422,31980,1766,25376,1791,1592,630,30388,1920,6604,1356,6235,1216
"279","01081","Lee County, Alabama",58555,1892,53580,2067,46192,2463,1988,733,51592,2148,7388,1449,4975,1094
"280","01083","Limestone County, Alabama",32816,1154,28659,1418,23698,1567,1509,560,27150,1570,4961,1111,4157,1103
"281","01089","Madison County, Alabama",147892,2670,136534,3152,119430,3843,7291,1328,129243,3273,17104,2051,11358,2035
"282","01095","Marshall County, Alabama",34083,1546,28966,1570,22365,1472,2448,852,26518,1502,6601,1214,5117,1038
"283","01097","Mobile County, Alabama",154683,2623,133862,3328,98372,3460,6700,1162,127162,3565,35490,3270,20821,2536
"284","01101","Montgomery County, Alabama",88554,2328,77828,2442,57518,3011,4067,853,73761,2355,20310,2279,10726,1703
"285","01103","Morgan County, Alabama",45360,1666,39938,1991,32100,2099,2673,816,37265,1910,7838,1530,5422,1243
"286","01115","St. Clair County, Alabama",33241,1228,28860,1513,23424,1628,1896,829,26964,1744,5436,1342,4381,1095
"287","01117","Shelby County, Alabama",78666,1740,74478,2043,65179,2403,2922,740,71556,2068,9299,1634,4188,1313
"288","01121","Talladega County, Alabama",31759,1666,26818,1826,17632,1866,1422,624,25396,1876,9186,1439,4941,925
"289","01125","Tuscaloosa County, Alabama",72243,2156,65263,2410,52510,2711,3696,907,61567,2401,12753,1720,6980,1358
"290","01127","Walker County, Alabama",25231,1131,20830,1317,14730,1278,1232,531,19598,1496,6100,1275,4401,821
"291","02020","Anchorage Municipality, Alaska",107373,1962,102938,2149,90592,2844,3977,889,98961,2169,12346,1894,4435,1182
"292","02090","Fairbanks North Star Borough, Alaska",35046,1911,33783,1931,29552,1593,978,476,32805,1899,4231,1352,1263,611
"293","02170","Matanuska-Susitna Borough, Alaska",29443,714,27521,815,24456,960,1610,428,25911,849,3065,607,1922,386
"294","04001","Apache County, Arizona",20550,889,12257,906,9077,867,1333,402,10924,907,3180,596,8293,745
"295","04003","Cochise County, Arizona",48939,2023,44467,1978,38947,1879,3878,852,40589,2097,5520,1166,4472,952
"296","04005","Coconino County, Arizona",47977,2031,43223,2269,35803,2165,1486,687,41737,2408,7420,1225,4754,951
"297","04013","Maricopa County, Arizona",1536579,7831,1440463,9349,1266647,10295,68597,4129,1371866,9904,173816,5588,96116,4555
"298","04015","Mohave County, Arizona",87565,2751,76935,3268,64243,3267,9153,1629,67782,3133,12692,2056,10630,1899
"299","04017","Navajo County, Arizona",36094,1644,28586,1411,22802,1469,2505,773,26081,1638,5784,946,7508,1035
"300","04019","Pima County, Arizona",403574,3977,375184,4463,319433,5017,24261,2077,350923,4836,55751,3694,28390,2360
"301","04021","Pinal County, Arizona",139097,3499,126228,3723,108885,3759,8064,1508,118164,3905,17343,2592,12869,2130
"302","04025","Yavapai County, Arizona",98369,2960,90199,3170,82283,3133,10052,1943,80147,3363,7916,1528,8170,1720
"303","04027","Yuma County, Arizona",74620,2261,65540,2558,50803,2645,2658,639,62882,2653,14737,2084,9080,1438
"304","05007","Benton County, Arkansas",97134,1708,90658,2144,76939,2495,3116,678,87542,2200,13719,2199,6476,1124
"305","05031","Craighead County, Arkansas",42115,1290,38255,1637,30599,1842,1553,535,36702,1678,7656,1467,3860,1009
"306","05045","Faulkner County, Arkansas",44870,1319,39948,1290,34029,1595,1584,513,38364,1363,5919,1196,4922,1049
"307","05051","Garland County, Arkansas",38594,1792,33835,1888,24773,2033,1537,568,32298,1831,9062,1875,4759,1319
"308","05069","Jefferson County, Arkansas",26537,1657,21874,1748,14297,1526,1294,449,20580,1718,7577,1286,4663,881
"309","05085","Lonoke County, Arkansas",27121,809,24536,1073,19896,1303,716,447,23820,1044,4640,1031,2585,802
"310","05119","Pulaski County, Arkansas",156546,2979,138981,3450,112225,4153,5941,1082,133040,3557,26756,2901,17565,2058
"311","05125","Saline County, Arkansas",44420,1474,40269,1798,32628,1922,1394,465,38875,1799,7641,1237,4151,969
"312","05131","Sebastian County, Arkansas",50734,1807,44642,2150,33406,2300,1778,604,42864,2182,11236,1898,6092,1328
"313","05143","Washington County, Arkansas",85290,2391,79772,2513,68735,2625,3662,891,76110,2609,11037,2194,5518,1455
"314","05145","White County, Arkansas",29067,1396,25882,1441,20270,1814,1200,535,24682,1340,5612,1218,3185,828
"315","06001","Alameda County, California",573589,3461,543674,4399,494613,4765,18614,1585,525060,4425,49061,2757,29915,2573
"316","06007","Butte County, California",88797,2187,83379,2283,73444,2524,6626,1268,76753,2692,9935,1685,5418,1122
"317","06013","Contra Costa County, California",392046,2369,373449,3516,336521,5361,13712,1704,359737,3897,36928,3758,18597,2348
"318","06017","El Dorado County, California",69368,2127,65654,2320,58895,2332,4698,1131,60956,2291,6759,1555,3714,1147
"319","06019","Fresno County, California",305819,2635,275225,3440,213916,4976,9311,1395,265914,3724,61309,4238,30594,2353
"320","06023","Humboldt County, California",53446,1854,49106,2025,41539,2280,3654,749,45452,2038,7567,1398,4340,898
"321","06025","Imperial County, California",44478,1682,38376,1849,30058,1659,1531,543,36845,1979,8318,1406,6102,1200
"322","06029","Kern County, California",269147,3367,237398,3874,190015,4268,9855,1682,227543,4363,47383,3250,31749,3397
"323","06031","Kings County, California",43029,1015,39891,1260,29653,1696,925,527,38966,1365,10238,1525,3138,741
"324","06033","Lake County, California",27399,1363,23258,1776,19845,1701,1817,656,21441,1806,3413,1035,4141,1206
"325","06037","Los Angeles County, California",3311231,8549,3066097,10221,2659928,12033,127481,4624,2938616,10440,406169,9342,245134,7582
"326","06039","Madera County, California",46282,1219,42219,1437,34077,1892,2368,673,39851,1597,8142,1739,4063,1235
"327","06041","Marin County, California",104219,2062,99140,2471,94258,2477,5196,1196,93944,2755,4882,1217,5079,1202
"328","06045","Mendocino County, California",32599,1509,28011,1799,24581,1704,2353,654,25658,1864,3430,901,4588,1118
"329","06047","Merced County, California",80969,1208,74361,1759,54367,2459,2871,708,71490,1915,19994,2044,6608,1280
"330","06053","Monterey County, California",125518,2011,115731,2202,96640,2667,4785,942,110946,2300,19091,1957,9787,1491
"331","06055","Napa County, California",47848,1322,44924,1457,41080,1475,2901,633,42023,1569,3844,812,2924,705
"332","06057","Nevada County, California",41638,1685,38815,1771,35912,1782,3051,889,35764,1846,2903,928,2823,890
"333","06059","Orange County, California",1037312,5286,991949,6240,901797,6813,34215,3020,957734,7444,90152,4956,45363,3316
"334","06061","Placer County, California",143659,1895,135619,2160,128769,2427,6077,1114,129542,2513,6850,1244,8040,1309
"335","06065","Riverside County, California",718733,5454,669548,6247,583718,6152,34844,2772,634704,6646,85830,4189,49185,3779
"336","06067","Sacramento County, California",543250,3675,513097,4077,447535,5166,23884,2127,489213,3843,65562,3938,30153,2633
"337","06071","San Bernardino County, California",626223,4247,591159,4909,485832,6637,22808,2390,568351,5084,105327,5902,35064,2612
"338","06073","San Diego County, California",1126419,6245,1077338,7643,973475,8269,38824,2541,1038514,8195,103863,4782,49081,3471
"339","06075","San Francisco County, California",360323,4331,335295,4738,308248,4994,10315,1583,324980,4694,27047,2955,25028,2290
"340","06077","San Joaquin County, California",226624,2501,207893,2804,168947,3458,9297,1254,198596,2942,38946,2619,18731,2291
"341","06079","San Luis Obispo County, California",104544,2839,99380,3010,90810,3251,5712,1102,93668,3323,8570,1713,5164,1335
"342","06081","San Mateo County, California",264185,2424,251857,2673,233689,3017,9338,1232,242519,2905,18168,2810,12328,1735
"343","06083","Santa Barbara County, California",147466,1981,138087,2331,124006,2756,9071,1369,129016,2593,14081,1955,9379,1646
"344","06085","Santa Clara County, California",633811,3358,610051,3789,569454,4600,19254,2130,590797,4070,40597,3649,23760,2353
"345","06087","Santa Cruz County, California",95940,2122,88927,2482,81003,2616,5163,1041,83764,2566,7924,1601,7013,1437
"346","06089","Shasta County, California",71968,1295,66062,1589,54764,1896,6488,1137,59574,1758,11298,1579,5906,1103
"347","06095","Solano County, California",151127,1649,142776,2073,125963,2410,6966,1197,135810,2408,16813,1936,8351,1573
"348","06097","Sonoma County, California",188829,2691,178187,3265,160792,3700,11562,1661,166625,3586,17395,2514,10642,1562
"349","06099","Stanislaus County, California",173573,1630,159925,2585,130382,3253,6886,1291,153039,2598,29543,2821,13648,1835
"350","06101","Sutter County, California",31945,907,28147,1315,23356,1556,1523,467,26624,1329,4791,983,3798,856
"351","06107","Tulare County, California",137576,1924,123935,2328,88821,2761,4901,1263,119034,2434,35114,2573,13641,1637
"352","06111","Ventura County, California",272085,2513,254928,3349,231826,3577,11274,1450,243654,3263,23102,2318,17157,1992
"353","06113","Yolo County, California",73495,1504,68585,1873,60805,2429,4290,966,64295,1984,7780,1577,4910,1226
"354","06115","Yuba County, California",26228,907,24171,1127,19048,1276,1777,665,22394,1139,5123,1021,2057,697
"355","08001","Adams County, Colorado",165730,1819,155697,2303,129738,3000,5697,1057,150000,2496,25959,2506,10033,1593
"356","08005","Arapahoe County, Colorado",240774,2112,230494,2292,208965,2690,8756,1105,221738,2395,21529,2227,10280,1218
"357","08013","Boulder County, Colorado",128497,1759,123993,1984,116715,2400,5984,1098,118009,2289,7278,1540,4504,1140
"358","08014","Broomfield County, Colorado",27665,629,26614,766,25469,863,931,379,25683,798,1145,489,1051,476
"359","08031","Denver County, Colorado",296938,2993,277631,3564,241939,4023,11478,1597,266153,3520,35692,2821,19307,2313
"360","08035","Douglas County, Colorado",119151,1850,116842,2011,113269,2079,3516,957,113326,2212,3573,946,2309,770
"361","08041","El Paso County, Colorado",258158,2406,245915,3201,226054,3829,10964,1457,234951,3204,19861,2736,12243,1883
"362","08059","Jefferson County, Colorado",231651,1904,222400,2528,206637,2889,12156,1392,210244,2334,15763,1971,9251,1563
"363","08069","Larimer County, Colorado",134709,2471,129718,2744,120856,3122,6224,1059,123494,2950,8862,1586,4991,1117
"364","08077","Mesa County, Colorado",61763,1535,56650,1734,48904,1871,4572,936,52078,1993,7746,1576,5113,1055
"365","08101","Pueblo County, Colorado",65098,1367,56801,1668,46894,1904,3761,816,53040,1721,9907,1103,8297,1144
"366","08123","Weld County, Colorado",104611,1323,98444,1604,87060,1886,5344,1167,93100,1973,11384,1412,6167,1237
"367","09001","Fairfield County, Connecticut",336433,3586,311863,3845,283460,4638,16791,1875,295072,3683,28403,2870,24570,2257
"368","09003","Hartford County, Connecticut",347565,3228,312790,4509,270674,4591,18635,1790,294155,4609,42116,3025,34775,2936
"369","09005","Litchfield County, Connecticut",73709,1790,67887,2032,61677,2098,5242,804,62645,2069,6210,1160,5822,1231
"370","09007","Middlesex County, Connecticut",67227,1912,62711,1967,56409,2320,4259,954,58452,2048,6302,1541,4516,920
"371","09009","New Haven County, Connecticut",324837,3662,288524,4103,252025,4191,17946,2052,270578,4153,36499,2890,36313,3115
"372","09011","New London County, Connecticut",107229,2683,97383,2765,86647,3132,6101,1112,91282,2802,10736,1699,9846,1498
"373","09013","Tolland County, Connecticut",55939,1391,52955,1584,48988,1814,3472,928,49483,1858,3967,999,2984,829
"374","09015","Windham County, Connecticut",43823,1624,39381,1614,34173,1835,3224,791,36157,1767,5208,1191,4442,960
"375","10001","Kent County, Delaware",63807,1705,59027,1963,49821,2318,4755,991,54272,2166,9206,1819,4780,1110
"376","10003","New Castle County, Delaware",206101,2034,195146,2735,151335,3639,8947,1194,186199,3165,43811,3549,10955,1395
"377","10005","Sussex County, Delaware",88029,2693,78197,2989,66573,2570,6123,1097,72074,3243,11624,1620,9832,1673
"378","11001","District of Columbia, District of Columbia",281475,3302,258760,3943,223698,4197,9499,1114,249261,4129,35062,3387,22715,2110
"379","12001","Alachua County, Florida",97714,2507,91117,2543,79983,2936,5262,1215,85855,2763,11134,1694,6597,1315
"380","12005","Bay County, Florida",70600,2581,65614,2841,54757,2656,3785,999,61829,2774,10857,1839,4986,1134
"381","12009","Brevard County, Florida",228385,4217,210247,4966,190454,5183,17075,1830,193172,4948,19793,2494,18138,2682
"382","12011","Broward County, Florida",685559,5668,639906,6152,562035,7168,26742,2340,613164,6653,77871,4693,45653,3303
"383","12015","Charlotte County, Florida",76056,2864,67912,2986,59378,2919,6086,1293,61826,3053,8534,1858,8144,1331
"384","12017","Citrus County, Florida",61290,2602,55714,2481,48645,2355,5697,938,50017,2377,7069,1527,5576,1188
"385","12019","Clay County, Florida",73136,2128,70117,2199,59712,3048,2425,677,67692,2094,10405,2178,3019,882
"386","12021","Collier County, Florida",144354,4069,133979,3811,117331,4091,7707,1493,126272,3755,16648,2069,10375,2082
"387","12023","Columbia County, Florida",24335,1258,21963,1350,18769,1388,1631,610,20332,1455,3194,881,2372,862
"388","12031","Duval County, Florida",359607,3522,323989,4759,271833,5513,15402,1678,308587,4703,52156,3901,35618,2946
"389","12033","Escambia County, Florida",122406,2545,112546,3160,97864,3319,8759,1278,103787,3334,14682,2326,9860,1787
"390","12035","Flagler County, Florida",42370,1682,38142,1845,34044,1827,2991,759,35151,1968,4098,1012,4228,1101
"391","12053","Hernando County, Florida",74110,2274,67103,2441,58886,2487,5329,1017,61774,2524,8217,1482,7007,1218
"392","12055","Highlands County, Florida",42948,2328,35067,2985,29119,2684,4363,1021,30704,2788,5948,1399,7881,1515
"393","12057","Hillsborough County, Florida",521609,4747,493769,5311,428295,5101,21051,2019,472718,5900,65474,4367,27840,2446
"394","12061","Indian River County, Florida",58044,2623,50620,2848,45320,2689,5504,1266,45116,3059,5300,1378,7424,1440
"395","12069","Lake County, Florida",136255,2937,125568,3387,110241,3210,7527,1443,118041,3545,15327,2021,10687,1928
"396","29187","St. Francois County, Missouri",22504,1609,19506,1686,15970,1597,1371,609,18135,1620,3536,828,2998,846
"397","29189","St. Louis County, Missouri",406823,3622,374102,4341,325415,5937,21774,2312,352328,4557,48687,4340,32721,3026
"398","29510","St. Louis city, Missouri",138513,2993,121322,3440,93360,3387,5593,1031,115729,3352,27962,2762,17191,2091
"399","30013","Cascade County, Montana",33346,1326,27499,1440,24596,1508,2357,540,25142,1558,2903,882,5847,997
"400","30029","Flathead County, Montana",37236,1723,32995,1750,29453,1598,2827,823,30168,1786,3542,994,4241,977
"401","30031","Gallatin County, Montana",44315,963,42918,1105,39916,1468,1711,494,41207,1178,3002,937,1397,491
"402","30049","Lewis and Clark County, Montana",28250,976,25249,1268,21890,1327,1850,595,23399,1255,3359,854,3001,860
"403","30063","Missoula County, Montana",48806,1498,44513,1896,41102,2108,2555,722,41958,1978,3411,1138,4293,1132
"404","30111","Yellowstone County, Montana",65962,1512,60138,1872,52043,2141,4137,1014,56001,1904,8095,1468,5824,1237
"405","31055","Douglas County, Nebraska",218390,2291,198567,3091,173041,3408,10659,1201,187908,3175,25526,2296,19823,1945
"406","31109","Lancaster County, Nebraska",122954,1823,115782,2068,103360,2738,6364,900,109418,2166,12422,1862,7172,1080
"407","31153","Sarpy County, Nebraska",65715,1067,62855,1078,57675,1320,2161,538,60694,1146,5180,1073,2860,575
"408","32003","Clark County, Nevada",781796,5934,728859,7035,616282,7942,31926,2124,696933,7134,112577,4987,52937,3797
"409","32031","Washoe County, Nevada",180851,2093,169933,2774,149654,3288,9039,1338,160894,2971,20279,2563,10918,1718
"410","33005","Cheshire County, New Hampshire",29385,1307,26358,1170,23240,1429,2501,666,23857,1247,3118,946,3027,728
"411","33009","Grafton County, New Hampshire",33672,1842,30837,2074,28785,2140,3893,859,26944,2002,2052,744,2835,849
"412","33011","Hillsborough County, New Hampshire",161414,1779,153026,2350,140427,2993,9976,1409,143050,2354,12599,1978,8388,1457
"413","33013","Merrimack County, New Hampshire",58220,1355,54205,1589,46897,1828,4716,845,49489,1685,7308,1448,4015,807
"414","33015","Rockingham County, New Hampshire",120096,2093,113784,2391,105476,2736,6935,1417,106849,2477,8308,1641,6312,1265
"415","33017","Strafford County, New Hampshire",48988,1341,46620,1396,43393,1876,2862,748,43758,1495,3227,1101,2368,588
"416","34001","Atlantic County, New Jersey",97618,2623,88929,2872,74863,2897,5795,1099,83134,2795,14066,1939,8689,1361
"417","34003","Bergen County, New Jersey",338516,2359,316429,3047,291036,3792,15473,1848,300956,3208,25393,2690,22087,2246
"418","34005","Burlington County, New Jersey",164248,2219,154450,2623,141156,2870,9355,1363,145095,2999,13294,1557,9798,1499
"419","34007","Camden County, New Jersey",190616,2205,174363,2919,150202,3952,10937,1343,163426,2980,24161,2932,16253,1874
"420","34009","Cape May County, New Jersey",39526,2005,36807,2070,32616,2064,2505,684,34302,2067,4191,880,2719,603
"421","34011","Cumberland County, New Jersey",50696,1437,45896,1640,36373,1840,3435,864,42461,1589,9523,1545,4800,837
"422","34013","Essex County, New Jersey",284928,2245,259607,3087,212309,3479,12730,1631,246877,3696,47298,2996,25321,2385
"423","34015","Gloucester County, New Jersey",105236,1734,98310,1916,88894,2664,5759,948,92551,2164,9416,1720,6926,1251
"424","34017","Hudson County, New Jersey",251906,3272,233700,3525,198595,3449,7770,1190,225930,3586,35105,2899,18206,1900
"425","34019","Hunterdon County, New Jersey",45967,1264,43820,1421,40883,1447,2029,656,41791,1566,2937,863,2147,750
"426","34021","Mercer County, New Jersey",128757,2083,118128,2479,101546,2622,6378,1384,111750,2585,16582,1904,10629,1356
"427","34023","Middlesex County, New Jersey",285446,2819,265755,3002,241435,4114,11676,1155,254079,3146,24320,2935,19691,1926
"428","34025","Monmouth County, New Jersey",235727,2611,221592,2869,202330,3125,11292,1336,210300,2961,19262,2532,14135,1763
"429","34027","Morris County, New Jersey",180854,2444,172559,2570,161340,3375,9779,1587,162780,2824,11219,1767,8295,1218
"430","34029","Ocean County, New Jersey",225847,3679,204650,3921,184978,4366,19060,1867,185590,3720,19672,2375,21197,2188
"431","34031","Passaic County, New Jersey",168397,1897,152658,2498,128576,3064,6408,1060,146250,2599,24082,2347,15739,1801
"432","34033","Salem County, New Jersey",24801,922,21821,1135,18661,1169,1365,476,20456,1117,3160,796,2980,730
"433","34035","Somerset County, New Jersey",114812,2105,109423,2338,104342,2349,7076,1337,102347,2449,5081,987,5389,1089
"434","34037","Sussex County, New Jersey",53396,1572,50707,1444,45966,1591,2825,610,47882,1630,4741,1032,2689,683
"435","34039","Union County, New Jersey",190138,1786,172676,2690,150864,3066,8938,1390,163738,2665,21812,2121,17462,1989
"436","34041","Warren County, New Jersey",41366,1163,38170,1417,34422,1493,3313,964,34857,1633,3748,1078,3196,872
"437","35001","Bernalillo County, New Mexico",264827,3114,242474,3815,206304,4416,15660,1799,226814,3506,36170,2935,22353,2513
"438","35005","Chaves County, New Mexico",23002,1152,18597,1316,14448,1395,1489,606,17108,1272,4149,1005,4405,909
"439","35013","Doña Ana County, New Mexico",75441,2513,64842,3049,51757,3567,3989,1201,60853,3000,13085,2221,10599,1675
"440","35025","Lea County, New Mexico",22222,1083,19767,1209,13052,1272,989,418,18778,1269,6715,1441,2455,720
"441","35031","McKinley County, New Mexico",21083,640,14588,820,9156,1007,1142,413,13446,908,5432,922,6495,709
"442","35035","Otero County, New Mexico",23007,1488,20079,1518,15658,1491,1386,469,18693,1556,4421,1167,2928,959
"443","35043","Sandoval County, New Mexico",50873,1230,45857,1401,41739,1574,3030,974,42827,1498,4118,828,5016,815
"444","35045","San Juan County, New Mexico",41071,1584,33478,1647,25916,1649,2491,694,30987,1672,7562,1127,7593,1222
"445","35049","Santa Fe County, New Mexico",60904,1872,53723,2023,47745,2059,3343,718,50380,2096,5978,1034,7181,1094
"446","35061","Valencia County, New Mexico",26359,1301,23316,1450,18911,1599,1732,727,21584,1608,4405,1118,3043,980
"447","36001","Albany County, New York",124144,2156,112642,2279,101013,2697,7516,1322,105126,2405,11629,1913,11502,1570
"448","36005","Bronx County, New York",503985,3195,447009,4735,318136,7133,17667,2431,429342,5301,128873,6343,56976,4016
"449","36007","Broome County, New York",78604,2009,68547,2013,60300,2125,6992,936,61555,2185,8247,1212,10057,1326
"450","36009","Cattaraugus County, New York",32360,1144,26935,1187,21761,1159,4020,691,22915,1062,5174,809,5425,802
"451","36011","Cayuga County, New York",30870,994,26794,1109,23802,1140,2720,646,24074,1184,2992,617,4076,747
"452","36013","Chautauqua County, New York",51985,2010,43739,1962,38247,1933,5377,883,38362,1963,5492,1134,8246,1219
"453","36015","Chemung County, New York",32247,1594,29630,1487,25055,1596,3089,604,26541,1593,4575,995,2617,634
"454","36019","Clinton County, New York",31493,1193,28274,1313,24282,1538,2432,645,25842,1284,3992,923,3219,738
"455","36027","Dutchess County, New York",106043,1981,97596,2329,88054,2566,7276,1036,90320,2621,9542,1601,8447,1281
"456","36029","Erie County, New York",386396,4036,340086,4374,285009,5029,28444,2474,311642,4955,55077,3971,46310,2461
"457","36045","Jefferson County, New York",41548,1763,37923,1885,32634,1920,4172,801,33751,1808,5289,1001,3625,872
"458","36047","Kings County, New York",956223,5436,841541,7162,723697,7850,39853,3046,801688,7696,117844,5502,114682,5242
"459","36051","Livingston County, New York",24725,1147,22743,1186,19622,1312,1903,510,20840,1169,3121,736,1982,477
"460","36053","Madison County, New York",26024,1451,22709,1525,20228,1463,2118,625,20591,1529,2481,704,3315,717
"461","36055","Monroe County, New York",301619,3421,270564,3947,231617,4176,18000,2001,252564,4271,38947,2760,31055,2609
"462","36059","Nassau County, New York",446978,2927,416368,3747,379413,4478,18327,2004,398041,4019,36955,3022,30610,2807
"463","36061","New York County, New York",764218,7019,701689,7382,634836,8450,32425,3587,669264,8222,66853,4375,62529,4296
"464","36063","Niagara County, New York",88659,1679,75853,2245,65708,2436,6966,1089,68887,2473,10145,1499,12806,1498
"465","36065","Oneida County, New York",88790,2407,77294,2527,65808,2028,7034,893,70260,2607,11486,1707,11496,1273
"466","36067","Onondaga County, New York",185709,2562,162583,2675,144644,2660,11666,1399,150917,2837,17939,1659,23126,2162
"467","36069","Ontario County, New York",44414,1455,40174,1623,36304,1511,2857,724,37317,1696,3870,868,4240,1033
"468","36071","Orange County, New York",127517,2481,114886,2488,101038,2925,6725,1148,108161,2456,13848,1889,12631,1696
"469","36075","Oswego County, New York",45971,1507,42430,1630,35177,1786,3512,798,38918,1609,7253,1251,3541,800
"470","36079","Putnam County, New York",34549,1117,32561,1215,30533,1271,2302,735,30259,1366,2028,784,1988,742
"471","36081","Queens County, New York",769258,5311,703302,6580,594604,7254,30179,2350,673123,7150,108698,5923,65956,4082
"472","36083","Rensselaer County, New York",66127,1231,59190,1552,51452,1873,4462,1082,54728,1826,7738,1398,6937,1085
"473","36085","Richmond County, New York",165990,2568,149379,2770,133907,2901,10883,2010,138496,3187,15472,2339,16611,1928
"474","36087","Rockland County, New York",100167,1392,88838,1910,79306,2022,6939,1277,81899,2255,9532,1786,11329,1737
"475","36089","St. Lawrence County, New York",41008,1362,36576,1468,29951,1490,3933,705,32643,1425,6625,1122,4432,848
"476","36091","Saratoga County, New York",97021,1647,90550,2001,83141,2419,6978,1221,83572,2193,7409,1469,6471,1152
"477","36093","Schenectady County, New York",49022,2193,45616,2159,37872,2081,3570,675,42046,2094,7744,1255,3406,641
"478","36101","Steuben County, New York",38382,1623,33571,1512,29218,1414,3225,738,30346,1456,4353,749,4811,845
"479","36103","Suffolk County, New York",482099,5656,445631,5760,410998,6139,28140,2328,417491,6247,34633,3460,36468,3506
"480","36105","Sullivan County, New York",25916,1865,22660,1814,19411,1769,2214,672,20446,1768,3249,1005,3256,861
"481","36109","Tompkins County, New York",40230,1323,37432,1431,34493,1761,2815,712,34617,1600,2939,1012,2798,842
"482","36111","Ulster County, New York",68822,2184,64744,2172,58128,2606,6950,1364,57794,2433,6616,1360,4078,915
"483","36113","Warren County, New York",27595,1268,25026,1422,21954,1333,2315,543,22711,1480,3072,794,2569,671
"484","36117","Wayne County, New York",36715,976,32554,1339,27831,1215,2705,683,29849,1431,4723,962,4161,931
"485","36119","Westchester County, New York",350919,3361,324962,4265,285149,4388,14444,1699,310518,4373,39813,2863,25957,2564
"486","37001","Alamance County, North Carolina",64371,1425,58148,1629,45152,1973,3854,783,54294,1559,12996,1713,6223,1263
"487","37019","Brunswick County, North Carolina",56399,2486,51426,2623,44301,2174,3035,632,48391,2626,7125,1337,4973,954
"488","37021","Buncombe County, North Carolina",107752,2253,95468,2764,82114,3397,7921,1219,87547,2993,13354,2312,12284,1640
"489","37023","Burke County, North Carolina",33682,1515,27285,1769,21840,1692,2489,732,24796,1770,5445,1244,6397,1314
"490","37025","Cabarrus County, North Carolina",75188,1297,69942,1662,63156,1956,3539,1001,66403,1988,6786,1512,5246,1223
"491","37027","Caldwell County, North Carolina",32245,1226,26081,1638,21187,1638,2249,565,23832,1589,4894,1178,6164,1259
"492","37031","Carteret County, North Carolina",29944,1459,27532,1518,24543,1492,2178,492,25354,1500,2989,681,2412,654
"493","37035","Catawba County, North Carolina",61828,1572,53930,1911,43959,2317,3029,810,50901,1964,9971,1924,7898,1322
"494","37037","Chatham County, North Carolina",28929,1105,25997,1244,22704,1338,2222,661,23775,1208,3293,973,2932,836
"495","37045","Cleveland County, North Carolina",39609,1034,31184,1649,23713,1883,2896,879,28288,1605,7471,1274,8425,1277
"496","37049","Craven County, North Carolina",39866,1591,36814,1622,30624,1876,2611,712,34203,1735,6190,1489,3052,867
"497","37051","Cumberland County, North Carolina",127702,1767,115419,2173,96533,2240,6648,1064,108771,2271,18886,1977,12283,1365
"498","37057","Davidson County, North Carolina",66295,1833,58543,2065,47987,2445,4459,829,54084,2236,10556,1631,7752,1379
"499","37063","Durham County, North Carolina",126123,1989,115915,2427,97452,3084,3735,702,112180,2296,18463,2703,10208,1780
"500","37067","Forsyth County, North Carolina",144681,2547,130698,2654,109793,3143,7893,1208,122805,2927,20905,2238,13983,1685
"501","37069","Franklin County, North Carolina",24413,1309,21486,1551,17930,1592,1083,491,20403,1621,3556,937,2927,961
"502","37071","Gaston County, North Carolina",84200,1398,73075,2087,59471,2209,3389,717,69686,1977,13604,1518,11125,1561
"503","37081","Guilford County, North Carolina",203199,2753,178263,3327,153123,3428,10261,1551,168002,3832,25140,2658,24936,2778
"504","37085","Harnett County, North Carolina",46661,1021,42383,1177,34827,1688,1576,426,40807,1148,7556,1356,4278,775
"505","37089","Henderson County, North Carolina",47920,1729,43127,1875,36185,1948,3055,943,40072,1859,6942,1445,4793,1061
"506","37097","Iredell County, North Carolina",65662,1659,58321,1985,52096,2073,3999,1034,54322,2118,6225,1184,7341,1063
"507","37101","Johnston County, North Carolina",69048,1685,63645,1697,54938,1928,3094,1011,60551,1781,8707,1671,5403,1164
"508","37109","Lincoln County, North Carolina",33244,884,29118,1334,25551,1450,1257,528,27861,1400,3567,826,4126,983
"509","37119","Mecklenburg County, North Carolina",410770,3975,387183,4724,340202,5265,13006,1612,374177,4698,46981,3862,23587,2464
"510","37125","Moore County, North Carolina",39155,1642,34742,1768,30533,1688,2816,627,31926,1950,4209,949,4413,1047
"511","37127","Nash County, North Carolina",36248,1513,30928,1773,25290,1815,2149,763,28779,1648,5638,1335,5320,1257
"512","37129","New Hanover County, North Carolina",95097,2424,89803,2620,79243,2835,4646,1027,85157,2870,10560,1987,5294,1329
"513","37133","Onslow County, North Carolina",62941,2875,58782,2977,51675,2846,1719,635,57063,3051,7107,1537,4159,892
"514","37135","Orange County, North Carolina",53607,1244,50548,1459,46854,1636,1717,748,48831,1554,3694,1020,3059,912
"515","37147","Pitt County, North Carolina",68505,2253,62772,2710,52848,3077,3069,1134,59703,2798,9924,1890,5733,1277
"516","37151","Randolph County, North Carolina",57766,1286,51244,1773,40750,2394,3628,955,47616,1932,10494,1523,6522,1174
"517","37155","Robeson County, North Carolina",45351,1220,36025,1513,22372,1365,2397,662,33628,1548,13653,1331,9326,1082
"518","37157","Rockingham County, North Carolina",36175,1341,30386,1650,23602,1557,2077,792,28309,1787,6784,1313,5789,1057
"519","37159","Rowan County, North Carolina",52057,1968,45588,2129,38495,2243,2849,701,42739,2182,7093,1488,6469,1325
"520","37161","Rutherford County, North Carolina",26408,1666,21548,1657,17696,1861,3049,842,18499,1740,3852,1108,4860,1204
"521","37171","Surry County, North Carolina",29415,1052,23802,1265,19953,1248,2990,878,20812,1265,3849,925,5613,964
"522","37179","Union County, North Carolina",75366,1314,71132,1429,63103,1903,3060,691,68072,1510,8029,1451,4234,820
"523","37183","Wake County, North Carolina",400418,3673,387432,3997,354527,4878,14018,2102,373414,4299,32905,2802,12986,2049
"524","37191","Wayne County, North Carolina",47720,1488,42468,1669,35307,2095,3014,907,39454,1901,7161,1555,5252,1131
"525","37193","Wilkes County, North Carolina",28377,1562,24343,1686,20824,1854,2690,797,21653,1499,3519,1030,4034,815
"526","37195","Wilson County, North Carolina",32015,1162,27596,1474,21923,1499,2428,782,25168,1597,5673,1017,4419,908
"527","38015","Burleigh County, North Dakota",39251,1007,35270,1401,30099,1724,2453,674,32817,1385,5171,1337,3981,913
"528","38017","Cass County, North Dakota",76123,1628,71069,1849,64505,2213,2854,826,68215,2054,6564,1249,5054,1119
"529","38035","Grand Forks County, North Dakota",30848,729,27784,1083,24333,1240,1278,502,26506,1223,3451,931,3064,831
"530","38101","Ward County, North Dakota",27173,1394,25232,1406,22569,1549,1670,523,23562,1411,2663,847,1941,657
"531","39003","Allen County, Ohio",40872,993,36392,1137,29609,1413,2983,573,33409,1233,6783,1187,4480,897
"532","39007","Ashtabula County, Ohio",36704,1503,31700,1508,24545,1524,2955,595,28745,1585,7155,1253,5004,1225
"533","39009","Athens County, Ohio",22199,1460,19794,1528,16189,1614,1514,478,18280,1569,3605,855,2405,559
"534","39013","Belmont County, Ohio",23520,1232,19725,1152,16964,1204,2051,529,17674,1066,2761,782,3795,688
"535","39017","Butler County, Ohio",139058,2476,129760,2798,112622,2917,7278,1012,122482,2940,17138,1766,9298,1231
"536","39023","Clark County, Ohio",54026,1322,48553,1498,39648,1539,3767,737,44786,1727,8905,1362,5473,832
"537","39025","Clermont County, Ohio",78198,1528,71852,1856,61093,2062,4443,909,67409,1815,10759,1868,6346,1301
"538","39029","Columbiana County, Ohio",39140,1452,33072,1626,26340,1732,3391,792,29681,1756,6732,1212,6068,1058
"539","39035","Cuyahoga County, Ohio",544208,4413,477676,5519,390772,5946,31974,2386,445702,6002,86904,4667,66532,3045
"540","39041","Delaware County, Ohio",70224,916,68266,1137,63207,1478,2388,672,65878,1199,5059,1018,1958,633
"541","39043","Erie County, Ohio",31893,1386,28898,1466,24486,1625,2707,744,26191,1507,4412,1183,2995,803
"542","39045","Fairfield County, Ohio",55674,1319,50720,1671,44830,1792,3278,638,47442,1636,5890,1192,4954,1076
"543","39049","Franklin County, Ohio",508811,4386,475884,5439,406209,6417,19308,2185,456576,5767,69675,5282,32927,2895
"544","39055","Geauga County, Ohio",35216,801,31378,1035,28668,1115,2640,792,28738,1023,2710,837,3838,671
"545","39057","Greene County, Ohio",64517,1613,59293,1908,54230,1894,4282,1063,55011,1972,5063,1146,5224,1199
"546","39061","Hamilton County, Ohio",342793,3056,311473,3646,252063,5167,17056,2039,294417,4009,59410,4474,31320,2787
"547","39063","Hancock County, Ohio",31844,1080,29223,1127,25011,1479,1942,666,27281,1268,4212,1089,2621,741
"548","39081","Jefferson County, Ohio",26996,1212,23041,1366,18631,1413,1955,490,21086,1382,4410,1000,3955,706
"549","39085","Lake County, Ohio",94118,1894,85403,2139,76447,2498,7437,1073,77966,2342,8956,1461,8715,1585
"550","39089","Licking County, Ohio",63391,1661,58258,1920,51151,2340,4460,872,53798,1982,7107,1321,5133,1057
"551","39093","Lorain County, Ohio",120394,1862,107596,2346,93493,2626,7251,1092,100345,2398,14103,1926,12798,1545
"552","39095","Lucas County, Ohio",178672,2599,160636,2670,129771,3023,10366,1446,150270,3313,30865,2655,18036,1735
"553","39099","Mahoning County, Ohio",98084,1931,84756,2196,67414,2648,5865,948,78891,2177,17342,2122,13328,1610
"554","39101","Marion County, Ohio",24971,873,22008,1083,17498,1315,1753,587,20255,1108,4510,1125,2963,699
"555","39103","Medina County, Ohio",68650,1276,64936,1503,58128,1746,3455,619,61481,1513,6808,1139,3714,810
"556","39109","Miami County, Ohio",39819,1318,36333,1552,31628,1574,2800,695,33533,1563,4705,1154,3486,892
"557","39113","Montgomery County, Ohio",225106,2931,202456,3437,164937,3521,13321,1685,189135,3533,37519,2790,22650,2047
"558","39119","Muskingum County, Ohio",33074,1364,27921,1436,22301,1622,2109,629,25812,1580,5620,1191,5153,1037
"559","39133","Portage County, Ohio",62293,1401,56199,1836,50300,1976,3801,1023,52398,1990,5899,1279,6094,1264
"560","39139","Richland County, Ohio",48998,1322,42393,1675,32728,1899,3824,1046,38569,1759,9665,1717,6605,1201
"561","39141","Ross County, Ohio",27914,1433,24946,1386,20300,1499,1715,510,23231,1416,4646,1016,2968,825
"562","39145","Scioto County, Ohio",30424,1356,24518,1621,19710,1514,1863,659,22655,1465,4808,933,5906,1161
"563","39151","Stark County, Ohio",154097,2237,137067,2376,113379,2902,9607,1350,127460,2489,23688,2353,17030,1701
"564","39153","Summit County, Ohio",226989,2697,203219,3596,175079,4046,13814,1607,189405,3611,28140,2387,23770,2387
"565","39155","Trumbull County, Ohio",86886,1667,74042,2141,61251,2228,7008,1191,67034,2291,12791,1568,12844,1624
"566","39157","Tuscarawas County, Ohio",37446,905,31777,1156,24562,1636,2659,521,29118,1309,7215,1421,5669,907
"567","39165","Warren County, Ohio",83158,1586,79746,1866,72395,2362,2883,896,76863,1954,7351,1565,3412,846
"568","39169","Wayne County, Ohio",42890,1033,36968,1183,31963,1275,3796,782,33172,1143,5005,989,5922,762
"569","39173","Wood County, Ohio",49805,1407,46695,1574,43140,1649,3158,647,43537,1574,3555,835,3110,742
"570","40017","Canadian County, Oklahoma",44814,1129,42067,1246,35704,1324,1958,656,40109,1284,6363,1059,2747,784
"571","40027","Cleveland County, Oklahoma",106080,2019,102016,2095,89574,2761,3355,929,98661,2306,12442,2135,4064,918
"572","40031","Comanche County, Oklahoma",43901,1461,40534,1479,31355,1849,1805,526,38729,1564,9179,1487,3367,782
"573","40037","Creek County, Oklahoma",26390,635,23016,897,18061,850,1226,275,21790,925,4955,667,3374,585
"574","40101","Muskogee County, Oklahoma",26122,806,21289,821,15218,891,1267,429,20022,869,6071,798,4833,723
"575","40109","Oklahoma County, Oklahoma",297945,3809,270498,3696,219041,3466,14303,1520,256195,3876,51457,3087,27447,2057
"576","40119","Payne County, Oklahoma",30009,1360,27527,1402,24116,1455,1100,451,26427,1457,3411,884,2482,679
"577","40125","Pottawatomie County, Oklahoma",25877,736,22631,961,16805,959,1723,508,20908,1017,5826,843,3246,639
"578","40131","Rogers County, Oklahoma",34495,703,32310,744,27218,889,1956,446,30354,832,5092,678,2185,396
"579","40143","Tulsa County, Oklahoma",251055,2202,230262,2654,188066,3116,9943,1036,220319,2685,42196,2250,20793,1495
"580","40145","Wagoner County, Oklahoma",28307,668,26934,760,21956,871,1781,414,25153,802,4978,626,1373,367
"581","41003","Benton County, Oregon",35445,1109,34641,1194,32615,1289,1386,447,33255,1238,2026,802,804,325
"582","41005","Clackamas County, Oregon",157257,2122,148657,2540,137236,2569,9070,1440,139587,2723,11421,1650,8600,1547
"583","41017","Deschutes County, Oregon",74498,2649,71536,2706,66884,2830,3235,938,68301,2924,4652,1281,2962,1043
"584","41019","Douglas County, Oregon",45379,1457,39745,1768,31895,1888,4097,864,35648,1840,7850,1529,5634,1245
"585","41029","Jackson County, Oregon",89701,1578,80869,1808,71160,2073,5343,1006,75526,1838,9709,1617,8832,1643
"586","41033","Josephine County, Oregon",36493,959,32850,1267,28100,1700,3869,872,28981,1364,4750,1310,3643,1018
"587","41035","Klamath County, Oregon",27616,1302,24837,1320,19954,1157,1806,636,23031,1390,4883,923,2779,710
"588","41039","Lane County, Oregon",151675,2015,142560,2306,126171,2906,12653,1618,129907,2536,16389,2017,9115,1454
"589","41043","Linn County, Oregon",47188,1216,42834,1507,36163,1954,2646,686,40188,1636,6671,1516,4354,952
"590","41047","Marion County, Oregon",115718,2238,107805,2946,92293,3183,8144,1185,99661,2939,15512,2389,7913,1651
"591","41051","Multnomah County, Oregon",325039,3098,306514,3979,272288,4689,13729,1405,292785,3985,34226,3441,18525,2705
"592","41053","Polk County, Oregon",29260,1173,27044,1319,23900,1436,2118,661,24926,1404,3144,860,2216,736
"593","41059","Umatilla County, Oregon",27525,932,24499,1232,18060,1506,1417,533,23082,1221,6439,1246,3026,944
"594","41067","Washington County, Oregon",217894,2596,210447,3030,195685,3499,7845,1294,202602,2927,14762,2285,7447,1332
"595","41071","Yamhill County, Oregon",37629,873,34757,1301,30620,1414,3352,975,31405,1472,4137,1100,2872,1066
"596","42001","Adams County, Pennsylvania",39527,1005,34225,1275,29623,1342,3625,636,30600,1446,4602,704,5302,962
"597","42003","Allegheny County, Pennsylvania",537381,4512,481602,5512,414246,6335,34429,2721,447173,5503,67356,4458,55779,3047
"598","42005","Armstrong County, Pennsylvania",26712,999,22252,1241,19325,1232,2190,445,20062,1100,2927,585,4460,822
"599","42007","Beaver County, Pennsylvania",71005,1524,61014,1720,51087,1666,5456,877,55558,1874,9927,1286,9991,1240
"600","42011","Berks County, Pennsylvania",155154,2154,136495,2622,113544,3298,10813,1530,125682,2584,22951,2244,18659,1664
"601","42013","Blair County, Pennsylvania",51885,1043,44680,1578,38259,1601,4922,1025,39758,1716,6421,1132,7205,1059
"602","42017","Bucks County, Pennsylvania",239671,2395,221452,3292,202053,3888,13219,1641,208233,3239,19399,2169,18219,2124
"603","42019","Butler County, Pennsylvania",75513,1542,67954,1703,59715,2192,5024,876,62930,1888,8239,1417,7559,991
"604","42021","Cambria County, Pennsylvania",56023,1680,46988,1766,39868,1776,4733,644,42255,1765,7120,1023,9035,1034
"605","42025","Carbon County, Pennsylvania",26213,1520,22814,1607,18446,1604,2120,600,20694,1623,4368,990,3399,718
"606","42027","Centre County, Pennsylvania",58629,1590,53759,1703,50061,1739,3820,785,49939,1815,3698,1036,4870,975
"607","42029","Chester County, Pennsylvania",189506,2209,175090,2729,162382,3300,19015,1991,156075,2708,12708,1656,14416,2082
"608","42033","Clearfield County, Pennsylvania",29098,1272,23995,1288,20594,1180,2856,581,21139,1412,3401,792,5103,769
"609","42037","Columbia County, Pennsylvania",26584,937,23394,1060,19801,1191,1718,417,21676,1049,3593,742,3190,592
"610","42039","Crawford County, Pennsylvania",36050,1066,30308,1340,24929,1434,2912,560,27396,1275,5379,919,5742,838
"611","42041","Cumberland County, Pennsylvania",98242,1733,89136,2095,80351,2118,6265,1086,82871,2087,8785,1575,9106,1359
"612","42043","Dauphin County, Pennsylvania",110764,2360,96623,2751,83026,3049,9570,1607,87053,3011,13597,1686,14141,1506
"613","42045","Delaware County, Pennsylvania",205461,2694,190216,3073,167502,3348,11099,1410,179117,3314,22714,2143,15245,1778
"614","42049","Erie County, Pennsylvania",108458,1975,95170,2509,79260,2570,5928,1026,89242,2680,15910,1718,13288,1638
"615","42051","Fayette County, Pennsylvania",53256,1502,43466,1561,35927,1407,4119,771,39347,1673,7539,1334,9790,1302
"616","42055","Franklin County, Pennsylvania",60979,1311,53263,1625,46656,1973,4851,940,48412,1839,6607,1343,7716,1256
"617","42063","Indiana County, Pennsylvania",33664,1197,27913,1304,23231,1517,2998,620,24915,1189,4682,983,5751,970
"618","42069","Lackawanna County, Pennsylvania",86213,2225,74230,2457,62848,2910,6980,1115,67250,2426,11382,1679,11983,1490
"619","42071","Lancaster County, Pennsylvania",201150,1871,175731,2590,152140,2717,13861,1527,161870,3082,23591,2322,25419,2276
"620","42073","Lawrence County, Pennsylvania",37341,1107,32006,1188,27095,1281,2833,496,29173,1264,4911,979,5335,892
"621","42075","Lebanon County, Pennsylvania",52786,1327,46795,1567,39922,1710,3835,738,42960,1586,6873,1247,5991,938
"622","42077","Lehigh County, Pennsylvania",139466,1852,125681,2538,106937,2880,6801,1088,118880,2388,18744,2109,13785,1615
"623","42079","Luzerne County, Pennsylvania",126811,2908,108077,2994,89544,2885,10174,1318,97903,3166,18533,1899,18734,1611
"624","42081","Lycoming County, Pennsylvania",46122,1242,40926,1429,34501,1576,4437,781,36489,1397,6425,1013,5196,752
"625","42085","Mercer County, Pennsylvania",46453,1296,39583,1365,31984,1700,3450,603,36133,1443,7599,1282,6870,975
"626","42089","Monroe County, Pennsylvania",57668,2454,53073,2537,46676,2209,3271,980,49802,2631,6397,1467,4595,1263
"627","42091","Montgomery County, Pennsylvania",314756,2507,294449,3380,270102,3789,13842,1533,280607,3252,24347,2469,20307,2226
"628","42095","Northampton County, Pennsylvania",113945,1942,100692,2378,89615,2593,7424,1150,93268,2300,11077,1639,13253,1774
"629","42097","Northumberland County, Pennsylvania",37684,1257,31325,1481,25962,1449,3746,778,27579,1317,5363,871,6359,853
"630","42101","Philadelphia County, Pennsylvania",606142,4673,509676,6199,407082,7682,47138,3587,462538,6596,102594,5558,96466,4988
"631","42107","Schuylkill County, Pennsylvania",57492,1801,48572,2007,41004,1882,6064,1185,42508,2100,7568,1216,8920,1379
"632","42111","Somerset County, Pennsylvania",29405,1100,23781,985,19113,1036,2754,499,21027,1007,4668,766,5624,785
"633","42125","Washington County, Pennsylvania",81924,2078,72347,2169,61703,2092,5340,863,67007,2377,10644,1372,9577,1136
"634","42129","Westmoreland County, Pennsylvania",151007,2251,131020,2421,113946,2836,12678,1412,118342,2423,17074,1988,19987,1986
"635","42133","York County, Pennsylvania",171781,2489,152516,2890,128995,2968,11915,1349,140601,2818,23521,2461,19265,1792
"636","44003","Kent County, Rhode Island",69536,1409,63188,1834,55488,2299,4128,916,59060,1943,7700,1632,6348,1302
"637","44005","Newport County, Rhode Island",34568,1536,31845,1838,29452,1875,1924,628,29921,1891,2393,756,2723,902
"638","44007","Providence County, Rhode Island",237197,2787,209313,3586,175270,4702,12657,1507,196656,3739,34043,3177,27884,2283
"639","44009","Washington County, Rhode Island",47853,2182,45065,2217,40845,2320,3070,646,41995,2220,4220,1138,2788,804
"640","45003","Aiken County, South Carolina",67790,1797,61206,2164,49112,2262,4831,1025,56375,2038,12094,1769,6584,1327
"641","45007","Anderson County, South Carolina",76727,1839,67249,1937,53570,2393,4068,935,63181,2038,13679,1852,9478,1429
"642","45013","Beaufort County, South Carolina",68366,2530,64545,2437,55677,2530,2535,569,62010,2474,8868,1635,3821,1049
"643","45015","Berkeley County, South Carolina",75948,1788,70885,2006,59792,2300,2511,732,68374,2135,11093,1394,5063,963
"644","45019","Charleston County, South Carolina",158635,3288,144575,3455,124904,3797,7227,1729,137348,3886,19671,2645,14060,1741
"645","45031","Darlington County, South Carolina",27783,1146,21981,1545,17293,1654,1470,600,20511,1559,4688,1201,5802,1238
"646","45035","Dorchester County, South Carolina",56003,1584,52203,1692,46963,1963,2460,809,49743,1746,5240,1188,3800,1080
"647","45041","Florence County, South Carolina",51675,1517,43429,1699,33400,2109,2223,608,41206,1660,10029,1582,8246,1401
"648","45045","Greenville County, South Carolina",193456,2476,176287,2796,149397,3215,8684,1200,167603,3222,26890,2482,17169,1968
"649","45047","Greenwood County, South Carolina",26730,1336,22589,1289,17552,1527,1268,518,21321,1370,5037,1110,4141,882
"650","45051","Horry County, South Carolina",128499,4070,115959,4443,94573,4040,7650,1155,108309,4344,21386,2594,12540,1783
"651","45055","Kershaw County, South Carolina",25712,1207,21928,1455,19347,1453,1336,487,20592,1476,2581,836,3784,1014
"652","45057","Lancaster County, South Carolina",34262,1074,30286,1366,25321,1659,1566,677,28720,1385,4965,1275,3976,1080
"653","45059","Laurens County, South Carolina",25160,1413,21193,1518,15148,1652,2149,633,19044,1461,6045,1264,3967,952
"654","45063","Lexington County, South Carolina",110228,2347,102782,2501,85115,2857,5451,870,97331,2509,17667,2046,7446,1239
"655","45073","Oconee County, South Carolina",32189,1586,28671,1839,23327,1917,2288,727,26383,1837,5344,1334,3518,844
"656","45075","Orangeburg County, South Carolina",31870,1572,25213,1381,20835,1557,584,293,24629,1394,4378,1091,6657,1194
"657","45077","Pickens County, South Carolina",47824,1614,41752,1758,35710,2030,1983,530,39769,1739,6042,1360,6072,862
"658","45079","Richland County, South Carolina",151999,3048,142204,3348,117536,3427,4510,1004,137694,3477,24668,2722,9795,1587
"659","45083","Spartanburg County, South Carolina",115765,2353,102398,2666,83624,2817,6970,1229,95428,2866,18774,2132,13367,1614
"660","45085","Sumter County, South Carolina",41878,1433,36068,1555,28102,1758,1524,603,34544,1556,7966,1502,5810,1055
"661","45091","York County, South Carolina",100791,1638,93894,1957,80445,2542,3339,753,90555,2124,13449,2031,6897,1187
"662","46099","Minnehaha County, South Dakota",77045,1515,72006,1892,59611,1852,3856,781,68150,2026,12395,1635,5039,1037
"663","46103","Pennington County, South Dakota",43536,1211,38998,1446,34362,1543,4289,762,34709,1710,4636,1171,4538,1104
"664","47001","Anderson County, Tennessee",29929,1373,26152,1436,22182,1541,1702,594,24450,1422,3970,1037,3777,902
"665","47009","Blount County, Tennessee",50793,1567,43688,2061,36140,2113,2936,852,40752,2241,7548,1478,7105,1237
"666","47011","Bradley County, Tennessee",40610,1014,37097,1428,30836,1782,2326,684,34771,1424,6261,1164,3513,1010
"667","47037","Davidson County, Tennessee",283929,3870,264080,3877,227012,4559,9435,1366,254645,4137,37068,3049,19849,2035
"668","47059","Greene County, Tennessee",27249,1469,22386,1525,16850,1493,2252,786,20134,1617,5536,1106,4863,940
"669","47065","Hamilton County, Tennessee",145071,2135,128056,2770,101994,3053,6857,1433,121199,2969,26062,2426,17015,2014
"670","47093","Knox County, Tennessee",187098,2478,170925,2847,149623,3132,7719,1304,163206,3024,21302,1992,16173,1976
"671","47113","Madison County, Tennessee",36343,1383,30238,1601,25159,1810,1860,644,28378,1487,5079,1082,6105,1308
"672","47119","Maury County, Tennessee",33900,1236,31120,1328,26380,1535,1793,573,29327,1416,4740,1090,2780,742
"673","47125","Montgomery County, Tennessee",73690,2061,68992,2352,60493,2863,2790,938,66202,2470,8499,1768,4698,1202
"674","47141","Putnam County, Tennessee",30679,1294,26496,1732,22638,1829,1469,534,25027,1733,3858,1046,4183,989
"675","47147","Robertson County, Tennessee",25884,784,23325,915,18395,1197,968,404,22357,1035,4930,969,2559,770
"676","47149","Rutherford County, Tennessee",112519,2005,106197,2363,90861,3186,2944,849,103253,2404,15336,2274,6322,1490
"677","47155","Sevier County, Tennessee",36444,2095,32157,2376,26839,1999,1536,551,30621,2351,5318,1337,4287,1144
"678","47157","Shelby County, Tennessee",347221,4060,297184,4413,234771,4792,13091,1597,284093,4672,62413,5042,50037,2943
"679","47163","Sullivan County, Tennessee",67685,1587,58356,1993,49239,2280,4681,888,53675,2184,9117,1720,9329,1308
"680","47165","Sumner County, Tennessee",66063,1408,60523,1685,50990,1731,2576,764,57947,1648,9533,1359,5540,1244
"681","47179","Washington County, Tennessee",53071,1988,44881,2133,37453,2390,2188,715,42693,2183,7428,1755,8190,1401
"682","47187","Williamson County, Tennessee",77512,1780,74986,1926,71491,2058,1668,555,73318,1965,3495,938,2526,742
"683","47189","Wilson County, Tennessee",50234,1142,46647,1621,41492,1791,1620,618,45027,1526,5155,953,3587,1185
"684","48005","Angelina County, Texas",31544,1192,28350,1548,20449,1889,1183,539,27167,1579,7901,1508,3194,944
"685","48021","Bastrop County, Texas",24249,1668,22304,1745,18690,1775,2124,780,20180,1657,3614,1220,1945,915
"686","48027","Bell County, Texas",122333,2520,114568,2895,99198,3436,5236,1171,109332,3081,15370,2128,7765,1487
"687","48029","Bexar County, Texas",633422,4901,574214,5623,466490,6787,28285,2655,545929,5623,107724,5643,59208,3757
"688","48037","Bowie County, Texas",33164,1682,27098,1788,22135,1723,2095,781,25003,1869,4963,1252,6066,1380
"689","48039","Brazoria County, Texas",119770,2619,111813,2875,95510,3385,3713,996,108100,3076,16303,2433,7957,1496
"690","48041","Brazos County, Texas",79725,2344,74618,2558,63536,2848,1780,756,72838,2614,11082,2050,5107,1229
"691","48061","Cameron County, Texas",123024,2446,98765,2851,66296,3332,4301,1035,94464,3082,32469,2881,24259,2026
"692","48085","Collin County, Texas",338769,3681,332020,3914,306998,4156,6706,1429,325314,3892,25022,3235,6749,1360
"693","48091","Comal County, Texas",51662,1527,47668,1749,44367,1688,2331,592,45337,1825,3301,857,3994,1075
"694","48099","Coryell County, Texas",20335,1213,18896,1269,15879,1043,435,224,18461,1274,3017,856,1439,543
"695","48113","Dallas County, Texas",929078,5302,850463,6094,686429,7783,30491,2814,819972,6453,164034,6744,78615,4153
"696","48121","Denton County, Texas",293610,2601,287825,2763,264518,3548,6949,1293,280876,2816,23307,3073,5785,1497
"697","48135","Ector County, Texas",51388,1714,46356,2157,35349,2274,1334,636,45022,2018,11007,1754,5032,1168
"698","48139","Ellis County, Texas",57052,1263,54653,1372,45225,1651,2153,612,52500,1530,9428,1415,2399,742
"699","48141","El Paso County, Texas",269523,2823,235952,3400,186775,4356,8594,1419,227358,3856,49177,3897,33571,2682
"700","48157","Fort Bend County, Texas",235783,3701,229823,3968,210700,4387,5042,1296,224781,4157,19123,2784,5960,1603
"701","48167","Galveston County, Texas",121423,2641,113254,3048,94394,3220,4653,1220,108601,3175,18860,2383,8169,1523
"702","48181","Grayson County, Texas",49176,1611,43862,1881,35555,1854,2704,895,41158,1880,8307,1487,5314,1143
"703","48183","Gregg County, Texas",44138,1889,39834,1845,31278,1950,2693,885,37141,1794,8556,1521,4304,1081
"704","48187","Guadalupe County, Texas",55421,997,51399,1231,43853,2113,1860,484,49539,1226,7546,1634,4022,855
"705","48201","Harris County, Texas",1586849,9359,1476497,10485,1204564,13127,49929,3454,1426568,10789,271933,9614,110352,6059
"706","48203","Harrison County, Texas",22618,1202,18539,1488,15031,1781,1259,517,17280,1581,3508,1077,4079,863
"707","48209","Hays County, Texas",74995,1300,73033,1464,65475,1900,2308,1043,70725,1846,7558,1753,1962,730
"708","48213","Henderson County, Texas",32412,1498,28453,1568,21801,1812,1616,490,26837,1476,6652,1412,3959,949
"709","48215","Hidalgo County, Texas",239825,3843,211432,4243,132236,4446,6981,1613,204451,4647,79196,4778,28393,3053
"710","48231","Hunt County, Texas",32943,1387,29487,1662,24054,1819,1712,719,27775,1752,5433,1252,3456,786
"711","48245","Jefferson County, Texas",93735,2647,84649,2952,63980,3453,3312,862,81337,2990,20669,2700,9086,1498
"712","48251","Johnson County, Texas",58859,990,54278,1408,46400,1658,2177,678,52101,1576,7878,1257,4581,1035
"713","48257","Kaufman County, Texas",37569,1096,34933,1274,29140,1484,1396,518,33537,1427,5793,1037,2636,755
"714","48291","Liberty County, Texas",25482,1433,22887,1684,15710,2077,1049,594,21838,1846,7177,1794,2595,1050
"715","48303","Lubbock County, Texas",112290,2660,102474,3061,81142,3504,4239,1097,98235,3165,21332,2433,9816,1631
"716","48309","McLennan County, Texas",91086,2233,80200,2577,64952,3136,3458,662,76742,2519,15248,2042,10886,1610
"717","48329","Midland County, Texas",56745,1357,51820,1700,43489,2135,1267,600,50553,1824,8331,1760,4925,1215
"718","48339","Montgomery County, Texas",195637,3070,187188,3617,163348,4298,6473,1247,180715,3751,23840,3328,8449,1910
"719","48347","Nacogdoches County, Texas",22634,1391,20301,1515,16165,1426,1088,485,19213,1536,4136,1276,2333,731
"720","48355","Nueces County, Texas",128490,2585,115667,2830,81631,3434,5021,993,110646,2947,34036,2512,12823,1929
"721","48361","Orange County, Texas",29848,1585,27318,1853,21984,1565,968,526,26350,1834,5334,1082,2530,747
"722","48367","Parker County, Texas",44244,1710,42088,1749,37152,1976,2164,672,39924,1937,4936,979,2156,718
"723","48375","Potter County, Texas",45130,1375,40974,1468,28366,1984,1737,567,39237,1611,12608,1738,4156,872
"724","48381","Randall County, Texas",48941,1698,46841,1782,40693,1902,2750,785,44091,1858,6148,1298,2100,573
"725","48397","Rockwall County, Texas",31880,1043,30688,1141,29005,1219,732,446,29956,1166,1683,835,1192,548
"726","48409","San Patricio County, Texas",23075,1071,19831,1215,14883,1232,1236,471,18595,1301,4948,1125,3244,824
"727","48423","Smith County, Texas",77292,2117,72644,2258,48832,2744,3146,920,69498,2349,23812,2327,4648,1087
"728","48439","Tarrant County, Texas",703106,5974,666353,6568,566611,7779,23085,2532,643268,6642,99742,5329,36753,3316
"729","48441","Taylor County, Texas",50470,1444,45043,1864,36194,1885,1955,532,43088,1871,8849,1348,5427,1184
"730","48451","Tom Green County, Texas",42061,1729,37333,1973,28620,2011,1408,503,35925,2074,8713,1434,4728,926
"731","48453","Travis County, Texas",462632,4913,443217,5650,392965,6772,10408,1536,432809,6148,50252,3817,19415,2717
"732","48469","Victoria County, Texas",32778,1122,28663,1199,22412,1486,1031,409,27632,1267,6251,1043,4115,950
"733","48471","Walker County, Texas",22040,1324,20097,1400,15826,1629,651,390,19446,1457,4271,1411,1943,763
"734","48479","Webb County, Texas",74045,1601,58166,2313,44634,2680,2071,741,56095,2346,13532,1505,15879,1911
"735","48485","Wichita County, Texas",48382,2115,42999,2146,30881,1895,2030,574,40969,2218,12118,1707,5383,913
"736","48491","Williamson County, Texas",180142,2517,174472,2797,160071,3384,5140,1106,169332,2671,14401,2281,5670,1223
"737","48497","Wise County, Texas",21651,1013,19849,1102,15715,1364,788,487,19061,1278,4134,984,1802,545
"738","49005","Cache County, Utah",38453,789,37184,926,34495,1256,1436,515,35748,1068,2689,862,1269,543
"739","49011","Davis County, Utah",104788,1219,101242,1444,96686,1705,3077,763,98165,1594,4556,1221,3546,881
"740","49035","Salt Lake County, Utah",376314,2512,360266,3022,326774,3411,12168,1674,348098,3226,33492,3009,16048,1776
"741","49045","Tooele County, Utah",20555,595,20066,697,18282,966,445,276,19621,688,1784,583,489,246
"742","49049","Utah County, Utah",164698,1579,161713,1771,151862,2101,3565,637,158148,1823,9851,1378,2985,751
"743","49053","Washington County, Utah",56139,1972,51796,2223,47131,2283,2872,996,48924,2321,4665,1163,4343,1128
"744","49057","Weber County, Utah",83503,1868,78270,1982,69487,2169,3374,885,74896,2039,8783,1510,5233,1147
"745","50007","Chittenden County, Vermont",65703,1435,60951,1790,55610,1921,3624,841,57327,1987,5341,1500,4752,1182
"746","51003","Albemarle County, Virginia",41191,1269,39052,1443,35148,1565,2288,878,36764,1655,3904,998,2139,649
"747","51013","Arlington County, Virginia",104750,2143,101550,2133,94995,2535,2749,741,98801,2259,6555,1300,3200,1028
"748","51015","Augusta County, Virginia",30053,1062,24838,1479,21131,1476,3056,968,21782,1547,3707,1042,5215,1238
"749","51019","Bedford County, Virginia",31088,1204,27861,1521,23689,1694,1813,556,26048,1533,4172,1020,3227,922
"750","51041","Chesterfield County, Virginia",124142,1508,118923,1601,106211,2370,5432,984,113491,1713,12712,1805,5219,1091
"751","51059","Fairfax County, Virginia",396662,2748,384261,3044,359301,3649,12884,1614,371377,3090,24960,3036,12401,1757
"752","51061","Fauquier County, Virginia",23272,972,22094,1082,19555,1304,1035,387,21059,1059,2539,777,1178,491
"753","51069","Frederick County, Virginia",32251,1023,28901,1394,25680,1477,1334,480,27567,1475,3221,1012,3350,901
"754","51085","Hanover County, Virginia",37969,1223,35905,1355,31947,1583,2106,548,33799,1419,3958,995,2064,650
"755","51087","Henrico County, Virginia",127899,1861,118457,2326,103734,2595,6105,1325,112352,2524,14723,1863,9442,1496
"756","51095","James City County, Virginia",28085,1367,26349,1485,24474,1622,1184,625,25165,1517,1875,700,1736,633
"757","51107","Loudoun County, Virginia",129769,992,126016,1237,121302,1678,3568,793,122448,1551,4714,1064,3753,856
"758","51121","Montgomery County, Virginia",34336,1706,32313,1678,27184,2027,2063,749,30250,1645,5129,1553,2023,742
"759","51153","Prince William County, Virginia",141425,1703,138268,1843,128371,2607,4197,721,134071,2029,9897,1850,3157,917
"760","51161","Roanoke County, Virginia",38687,935,35398,1190,31149,1527,1981,549,33417,1211,4249,1055,3289,885
"761","51165","Rockingham County, Virginia",30892,1083,25600,1129,20737,1250,1788,506,23812,1237,4863,1025,5292,896
"762","51177","Spotsylvania County, Virginia",42960,1002,40990,1240,37940,1350,1583,471,39407,1306,3050,706,1970,611
"763","51179","Stafford County, Virginia",47474,993,46564,1068,43170,1321,1346,563,45218,1214,3394,1050,910,353
"764","51199","York County, Virginia",25294,1015,23719,1196,22269,1322,421,270,23298,1242,1450,663,1575,719
"765","51510","Alexandria city, Virginia",69667,1713,67735,1760,60861,1879,2381,811,65354,1826,6874,1461,1932,735
"766","51550","Chesapeake city, Virginia",83402,2082,79731,2179,71425,2461,3419,1026,76312,2261,8306,1690,3671,1036
"767","51650","Hampton city, Virginia",53267,1436,48869,1625,43412,2120,2852,805,46017,1590,5457,1390,4398,856
"768","51680","Lynchburg city, Virginia",27814,1456,25136,1538,20495,1827,2081,801,23055,1492,4641,1077,2678,597
"769","51700","Newport News city, Virginia",69249,2154,61101,2425,49168,2789,3383,1095,57718,2450,11933,1800,8148,1635
"770","51710","Norfolk city, Virginia",87857,2152,80803,2395,64700,2826,3236,606,77567,2381,16103,1963,7054,1014
"771","51740","Portsmouth city, Virginia",36246,1157,33068,1275,25836,1598,2365,610,30703,1418,7232,1233,3178,826
"772","51760","Richmond city, Virginia",87401,2053,78693,2156,63135,2470,3842,959,74851,2157,15558,1889,8708,1336
"773","51770","Roanoke city, Virginia",42133,1319,36705,1824,28182,2004,3221,885,33484,1821,8523,1508,5428,1183
"774","51800","Suffolk city, Virginia",33077,1054,30321,1124,25354,1392,1265,464,29056,1243,4967,1077,2756,572
"775","51810","Virginia Beach city, Virginia",168818,2960,161907,3248,146306,3729,6720,1200,155187,3651,15601,2164,6911,1117
"776","53005","Benton County, Washington",72265,1321,66469,1668,58548,2259,4421,1137,62048,1878,7921,1692,5796,1370
"777","53007","Chelan County, Washington",27060,1626,24879,1946,21454,1981,2012,687,22867,2107,3425,1148,2181,944
"778","53009","Clallam County, Washington",33233,994,29339,1267,25517,1376,4356,971,24983,1543,3822,819,3894,936
"779","53011","Clark County, Washington",173579,2122,165525,2529,150540,2927,8065,1154,157460,2951,14985,1917,8054,1444
"780","53015","Cowlitz County, Washington",41611,1081,37314,1399,31843,1495,2927,803,34387,1360,5471,1047,4297,931
"781","53021","Franklin County, Washington",26477,798,25114,1062,20566,1510,1165,623,23949,1230,4548,1231,1363,700
"782","53025","Grant County, Washington",31123,1359,28803,1509,22914,1600,2032,694,26771,1759,5889,1106,2320,783
"783","53027","Grays Harbor County, Washington",29286,1312,25133,1486,21261,1565,2193,466,22940,1422,3872,985,4153,936
"784","53029","Island County, Washington",34537,1361,33275,1394,29871,1459,2428,751,30847,1400,3404,1036,1262,454
"785","53033","King County, Washington",876639,5665,839219,7140,774324,7452,30382,2585,808837,7306,64895,4235,37420,3730
"786","53035","Kitsap County, Washington",104902,1850,100294,2114,92349,2662,6217,1295,94077,2154,7945,1870,4608,1105
"787","53041","Lewis County, Washington",31786,995,28610,1304,24388,1393,2612,647,25998,1434,4222,1044,3176,867
"788","53053","Pierce County, Washington",321268,3552,303360,3799,269866,4588,15144,1402,288216,4094,33494,2805,17908,2157
"789","53057","Skagit County, Washington",49262,1172,45782,1441,39726,1833,2880,578,42902,1410,6056,1050,3480,784
"790","53061","Snohomish County, Washington",292430,2330,279927,2958,258758,3788,12991,1494,266936,3184,21169,2365,12503,1856
"791","53063","Spokane County, Washington",200949,2388,187075,2879,163180,3164,11721,1476,175354,3066,23895,2183,13874,1698
"792","53067","Thurston County, Washington",112075,1401,105673,1653,96624,2197,5645,1146,100028,1966,9049,1600,6402,1370
"793","53073","Whatcom County, Washington",88636,1559,83486,2044,75726,2417,5866,1253,77620,2498,7760,1817,5150,1104
"794","53077","Yakima County, Washington",82107,1434,73305,1797,56575,2321,4356,1098,68949,1921,16730,1900,8802,1257
"795","54003","Berkeley County, West Virginia",42296,1475,37259,1700,30190,2035,2914,1077,34345,1671,7069,1639,5037,1263
"796","54011","Cabell County, West Virginia",41080,1127,34325,1626,27770,1998,2230,729,32095,1678,6555,1197,6755,1111
"797","54033","Harrison County, West Virginia",27493,963,24748,1146,19675,1460,2472,642,22276,1291,5073,1224,2745,741
"798","54039","Kanawha County, West Virginia",75836,2385,66166,2463,51917,2464,4535,960,61631,2443,14249,1803,9670,1342
"799","54061","Monongalia County, West Virginia",39386,1686,36245,1781,33165,1825,1791,486,34454,1781,3080,846,3141,841
"800","54081","Raleigh County, West Virginia",31593,1317,27159,1396,21846,1581,2438,665,24721,1587,5313,1284,4434,1005
"801","54107","Wood County, West Virginia",34462,1250,29675,1398,24349,1511,3658,944,26017,1525,5326,1480,4787,1015
"802","55009","Brown County, Wisconsin",104868,1381,94512,1708,82414,2019,4649,875,89863,1795,12098,1528,10356,1360
"803","55025","Dane County, Wisconsin",223031,2237,211707,2711,192932,3439,10570,1205,201137,2797,18775,2193,11324,1498
"804","55027","Dodge County, Wisconsin",34228,942,30047,1162,26581,1108,2827,530,27220,1227,3466,651,4181,767
"805","55035","Eau Claire County, Wisconsin",41767,903,38482,1023,34665,1271,2609,651,35873,1046,3817,907,3285,709
"806","55039","Fond du Lac County, Wisconsin",42449,902,37822,1218,33169,1239,2711,633,35111,1404,4653,933,4627,981
"807","55055","Jefferson County, Wisconsin",33534,654,29409,952,24868,1262,2120,461,27289,960,4541,969,4125,836
"808","55059","Kenosha County, Wisconsin",63546,1475,57835,1664,49463,2120,4735,1059,53100,1886,8372,1390,5711,999
"809","55063","La Crosse County, Wisconsin",47704,829,43514,1009,37772,1390,3807,896,39707,1147,5742,1113,4190,627
"810","55071","Manitowoc County, Wisconsin",34446,871,29963,1100,26394,1179,2985,642,26978,1094,3569,667,4483,816
"811","55073","Marathon County, Wisconsin",55084,1070,49344,1357,43362,1402,4112,674,45232,1439,5982,997,5740,901
"812","55079","Milwaukee County, Wisconsin",376445,3650,320766,4375,259008,4846,21168,1953,299598,4540,61758,3412,55679,3220
"813","55087","Outagamie County, Wisconsin",74033,918,68198,1309,60515,1543,4364,866,63834,1332,7683,1166,5835,1002
"814","55089","Ozaukee County, Wisconsin",35552,1216,33139,1269,30402,1497,2815,673,30324,1407,2737,930,2413,633
"815","55097","Portage County, Wisconsin",28679,588,25678,1077,22355,1155,2014,520,23664,1103,3323,728,3001,734
"816","55101","Racine County, Wisconsin",77473,1518,71529,1910,59091,2318,6057,1188,65472,2073,12438,1757,5944,1281
"817","55105","Rock County, Wisconsin",64878,1145,58048,1502,49740,1701,4362,844,53686,1687,8308,1185,6830,1154
"818","55109","St. Croix County, Wisconsin",34380,705,32309,839,29596,1066,1713,567,30596,992,2713,788,2071,550
"819","55117","Sheboygan County, Wisconsin",48347,798,43929,1212,38749,1742,3195,584,40734,1169,5180,1299,4418,943
"820","55127","Walworth County, Wisconsin",41071,1488,37986,1622,33540,1586,2700,606,35286,1725,4446,1067,3085,768
"821","55131","Washington County, Wisconsin",53985,935,49881,1325,45507,1616,3258,722,46623,1423,4374,952,4104,1035
"822","55133","Waukesha County, Wisconsin",159513,1640,151358,1844,140557,2305,10158,1417,141200,2177,10801,1741,8155,1229
"823","55139","Winnebago County, Wisconsin",70008,1386,64337,1730,56594,1738,5062,1009,59275,1794,7743,1200,5671,1004
"824","55141","Wood County, Wisconsin",32478,814,28167,1255,24746,1413,2678,692,25489,1349,3421,780,4311,955
"825","56021","Laramie County, Wyoming",39054,1455,36099,1750,32368,1956,2432,844,33667,1916,3731,1052,2955,1108
"826","56025","Natrona County, Wyoming",32556,1241,30292,1332,25406,1683,1453,503,28839,1307,4886,1292,2264,602
"827","72013","Arecibo Municipio, Puerto Rico",33702,1515,23505,1856,15567,1923,1707,644,21798,1836,7938,1781,10197,1482
"828","72021","Bayamón Municipio, Puerto Rico",63750,2407,53041,2365,33231,2222,2161,763,50880,2358,19810,1892,10709,1290
"829","72025","Caguas Municipio, Puerto Rico",46753,2035,35736,2207,24124,2032,2155,620,33581,2233,11612,1672,11017,1389
"830","72031","Carolina Municipio, Puerto Rico",64051,2092,52657,2674,34663,2755,2592,752,50065,2664,17994,2415,11394,1786
"831","72061","Guaynabo Municipio, Puerto Rico",26856,1447,21195,1632,15730,1565,1281,662,19914,1749,5465,1283,5661,1367
"832","72097","Mayagüez Municipio, Puerto Rico",29574,1776,20585,1999,13172,1717,1335,673,19250,2009,7413,1289,8989,1396
"833","72113","Ponce Municipio, Puerto Rico",50225,2142,33489,2485,23320,2122,3618,866,29871,2445,10169,1568,16736,2126
"834","72127","San Juan Municipio, Puerto Rico",140153,3176,89947,3568,62338,3130,9201,1582,80746,3527,27609,2445,50206,3195
"835","72135","Toa Alta Municipio, Puerto Rico",21640,1282,17191,1462,10957,1419,684,534,16507,1479,6234,1368,4449,1229
"836","72137","Toa Baja Municipio, Puerto Rico",27841,1510,21864,1568,13670,1559,901,419,20963,1578,8194,1394,5977,1265
"837","72139","Trujillo Alto Municipio, Puerto Rico",23564,1273,19702,1522,13407,1639,857,444,18845,1469,6295,1406,3862,821
