"","GEOID","NAME","B28010_001E","B28010_001M","B28010_002E","B28010_002M","B28010_003E","B28010_003M","B28010_004E","B28010_004M","B28010_005E","B28010_005M","B28010_006E","B28010_006M","B28010_007E","B28010_007M"
"1","01003","Baldwin County, Alabama",82325,3231,77281,3480,63551,3367,2759,1223,74522,3517,13730,2165,5044,1395
"2","01015","Calhoun County, Alabama",44636,2010,38833,2317,28390,2165,924,422,37909,2356,10443,1753,5803,1370
"3","01043","Cullman County, Alabama",32090,1233,27889,1303,20740,1451,1216,542,26673,1266,7149,1208,4201,886
"4","01049","DeKalb County, Alabama",24880,1347,21513,1469,14732,1536,686,342,20827,1465,6781,1341,3367,935
"5","01051","Elmore County, Alabama",30712,1330,27867,1566,20436,1787,547,306,27320,1632,7431,1522,2845,931
"6","01055","Etowah County, Alabama",40053,1930,35124,2134,23643,2060,1734,598,33390,2184,11481,1573,4929,1180
"7","01069","Houston County, Alabama",39761,1040,36174,1138,26308,1026,1528,425,34646,1158,9866,803,3587,523
"8","01073","Jefferson County, Alabama",264753,3376,240128,4326,188943,4790,9139,1593,230989,4109,51185,3653,24625,2348
"9","01077","Lauderdale County, Alabama",38761,1573,34254,1972,24331,1976,1310,594,32944,2062,9923,1439,4507,1061
"10","01081","Lee County, Alabama",64448,1810,59968,1982,51957,2501,2005,925,57963,2061,8011,1618,4480,1287
"11","01083","Limestone County, Alabama",32020,1530,29903,1493,24896,1594,866,422,29037,1499,5007,1060,2117,561
"12","01089","Madison County, Alabama",155878,2604,148135,2950,130344,3502,5743,1417,142392,3184,17791,2206,7743,1428
"13","01095","Marshall County, Alabama",35330,1274,31790,1581,23814,1592,1417,498,30373,1576,7976,1423,3540,798
"14","01097","Mobile County, Alabama",155946,2876,141238,3564,104642,3451,6739,1610,134499,3922,36596,2942,14708,2176
"15","01101","Montgomery County, Alabama",88864,2242,80859,2515,60988,3068,2701,921,78158,2712,19871,2792,8005,1477
"16","01103","Morgan County, Alabama",46470,1676,41134,1778,32087,2046,1888,531,39246,1842,9047,1445,5336,1376
"17","01115","St. Clair County, Alabama",32829,1261,31061,1526,25353,1987,1041,541,30020,1622,5708,1385,1768,959
"18","01117","Shelby County, Alabama",84048,1602,80702,1936,69343,2266,2396,600,78306,2047,11359,1845,3346,934
"19","01121","Talladega County, Alabama",30602,1841,25876,1821,18394,1585,815,442,25061,1808,7482,1359,4726,931
"20","01125","Tuscaloosa County, Alabama",74259,2679,67356,2989,53865,3038,1529,525,65827,3035,13491,2062,6903,1482
"21","01127","Walker County, Alabama",25153,1223,22267,1489,15080,1497,489,341,21778,1518,7187,1219,2886,940
"22","02020","Anchorage Municipality, Alaska",105198,2489,102657,2383,86693,2886,2379,651,100278,2442,15964,2278,2541,733
"23","02090","Fairbanks North Star Borough, Alaska",35556,1761,34315,1818,28609,1960,1571,711,32744,1829,5706,1460,1241,571
"24","02170","Matanuska-Susitna Borough, Alaska",32736,739,31384,777,26922,960,1229,353,30155,864,4462,760,1352,349
"25","04001","Apache County, Arizona",20925,946,12150,1020,8390,1036,1239,535,10911,1068,3760,889,8775,880
"26","04003","Cochise County, Arizona",51982,1532,47825,1587,40200,1802,3002,958,44823,1794,7625,1510,4157,1032
"27","04005","Coconino County, Arizona",48993,2018,46383,2065,38992,2281,1714,627,44669,2185,7391,1238,2610,559
"28","04013","Maricopa County, Arizona",1611722,9030,1548916,9190,1327442,10916,50381,2682,1498535,9563,221474,7798,62806,4457
"29","04015","Mohave County, Arizona",91095,3289,84662,3593,68945,3423,5411,1420,79251,3565,15717,2380,6433,1491
"30","04017","Navajo County, Arizona",38732,1795,32372,1923,22169,1601,1385,510,30987,1967,10203,1261,6360,829
"31","04019","Pima County, Arizona",410404,5277,386546,5969,315985,6026,16738,2010,369808,6234,70561,4404,23858,2346
"32","04021","Pinal County, Arizona",153413,3559,145368,3427,126213,3577,5904,1453,139464,3558,19155,2501,8045,1483
"33","04025","Yavapai County, Arizona",102784,2449,95332,2761,83488,3290,7143,1268,88189,2827,11844,2159,7452,1692
"34","04027","Yuma County, Arizona",74042,2409,67240,2860,49686,2551,2489,714,64751,2903,17554,2615,6802,1512
"35","05007","Benton County, Arkansas",100749,1952,95879,2170,81213,2526,2108,727,93771,2349,14666,1913,4870,1187
"36","05031","Craighead County, Arkansas",41409,1584,38696,1583,29276,2240,1200,518,37496,1742,9420,1962,2713,907
"37","05045","Faulkner County, Arkansas",47389,1263,45334,1325,37999,2102,1142,510,44192,1420,7335,1583,2055,628
"38","05051","Garland County, Arkansas",41743,1957,38215,2095,29508,2064,2382,829,35833,2097,8707,1735,3528,982
"39","05069","Jefferson County, Arkansas",27593,1255,23154,1708,14753,1495,784,425,22370,1697,8401,1404,4439,1139
"40","05085","Lonoke County, Arkansas",26052,1344,24116,1402,18472,1581,597,284,23519,1406,5644,1111,1936,664
"41","05119","Pulaski County, Arkansas",158000,3302,144185,3844,111252,4634,4886,1082,139299,3811,32933,3067,13815,1822
"42","05125","Saline County, Arkansas",45455,1550,41551,1787,30643,2329,1145,609,40406,1795,10908,1678,3904,971
"43","05131","Sebastian County, Arkansas",51384,1786,45490,2339,35406,2524,2258,775,43232,2404,10084,1622,5894,1429
"44","05143","Washington County, Arkansas",89249,2141,84628,2574,68294,2944,3161,966,81467,2621,16334,2416,4621,1432
"45","05145","White County, Arkansas",28621,1565,25108,1812,15584,1818,960,438,24148,1775,9524,1810,3513,812
"46","06001","Alameda County, California",585632,3709,558137,4565,502638,5591,14579,1581,543558,4813,55499,3769,27495,2955
"47","06007","Butte County, California",77651,1790,73685,1946,61770,2146,3117,774,70568,2081,11915,1491,3966,950
"48","06013","Contra Costa County, California",399792,2910,386715,3409,340569,5005,10571,1571,376144,3609,46146,3685,13077,2048
"49","06017","El Dorado County, California",74216,2393,70830,2539,64211,2890,2027,543,68803,2518,6619,1328,3386,1168
"50","06019","Fresno County, California",315974,2193,289522,3738,221789,5147,7628,1218,281894,3665,67733,4472,26452,2915
"51","06023","Humboldt County, California",55692,1614,51868,1925,44927,2056,3741,1008,48127,1981,6941,1330,3824,970
"52","06025","Imperial County, California",48182,1865,44324,1947,31131,2225,660,403,43664,2018,13193,2320,3858,839
"53","06029","Kern County, California",272888,3419,247290,4140,182636,5173,6826,1460,240464,4303,64654,4356,25598,3159
"54","06031","Kings County, California",44761,1150,41910,1306,31147,1957,1005,445,40905,1330,10763,1445,2851,786
"55","06033","Lake County, California",25968,1699,24128,1763,19064,1512,1682,749,22446,1845,5064,1371,1840,730
"56","06037","Los Angeles County, California",3328398,9311,3146631,11776,2668472,13953,77943,3960,3068688,12126,478159,10989,181767,6464
"57","06039","Madera County, California",44387,1836,42231,1817,31643,2144,1713,703,40518,1801,10588,1913,2156,810
"58","06041","Marin County, California",105298,1492,101450,1981,95307,2653,4269,998,97181,2228,6143,1660,3848,1338
"59","06045","Mendocino County, California",34478,1479,31064,1466,24420,1652,3433,958,27631,1903,6644,1519,3414,846
"60","06047","Merced County, California",80645,1718,75446,1935,56853,2564,1628,705,73818,2034,18593,2367,5199,1059
"61","06053","Monterey County, California",128227,2197,123742,2338,96093,2802,3707,798,120035,2402,27649,2610,4485,1157
"62","06055","Napa County, California",48107,1441,46009,1549,40137,1823,2601,672,43408,1584,5872,1461,2098,665
"63","06057","Nevada County, California",39365,2247,37754,2206,34536,2231,2148,624,35606,2212,3218,967,1611,648
"64","06059","Orange County, California",1044280,6750,1012117,7188,914883,8330,25136,2120,986981,7362,97234,5440,32163,3298
"65","06061","Placer County, California",147236,1902,143096,1802,134361,2292,4891,1071,138205,2103,8735,1464,4140,1002
"66","06065","Riverside County, California",734948,6129,702294,6675,606771,7541,26395,2760,675899,7071,95523,5259,32654,3592
"67","06067","Sacramento County, California",556752,2991,531833,3643,461673,5385,17400,2117,514433,3778,70160,4288,24919,2514
"68","06071","San Bernardino County, California",644758,4633,614667,5977,500655,7664,14475,1651,600192,6117,114012,6098,30091,2727
"69","06073","San Diego County, California",1132434,6683,1087793,7463,972137,8522,29688,2724,1058105,8006,115656,6275,44641,3427
"70","06075","San Francisco County, California",365851,4759,347877,5293,311777,5561,7576,1426,340301,5697,36100,3641,17974,2387
"71","06077","San Joaquin County, California",230241,2816,218680,3248,170950,4098,5963,988,212717,3402,47730,3436,11561,1497
"72","06079","San Luis Obispo County, California",106512,2641,103085,2927,92720,3369,4309,1075,98776,2808,10365,1726,3427,969
"73","06081","San Mateo County, California",265003,2718,255132,3288,234764,3836,6551,1265,248581,3660,20368,2504,9871,1363
"74","06083","Santa Barbara County, California",146466,2271,138734,2396,118047,3011,5865,1111,132869,2551,20687,2257,7732,1428
"75","06085","Santa Clara County, California",643637,4477,621594,5059,574379,5449,15708,1619,605886,5405,47215,3659,22043,2613
"76","06087","Santa Cruz County, California",97710,2076,93199,2564,82532,3197,4099,966,89100,2654,10667,2205,4511,1352
"77","06089","Shasta County, California",72714,1501,66155,1867,56204,2275,3692,913,62463,2012,9951,1614,6559,1298
"78","06095","Solano County, California",150393,1826,144521,2117,127518,2681,3883,825,140638,2103,17003,2113,5872,1030
"79","06097","Sonoma County, California",190689,2478,183362,2910,164722,3392,8094,1355,175268,3117,18640,2639,7327,1463
"80","06099","Stanislaus County, California",174698,2116,164873,2544,122140,3492,4778,1103,160095,2630,42733,3606,9825,1780
"81","06101","Sutter County, California",33039,731,29119,1181,24608,1397,1362,473,27757,1259,4511,1074,3920,952
"82","06103","Tehama County, California",25310,1013,23473,1181,19380,1562,1451,653,22022,1202,4093,1214,1837,680
"83","06107","Tulare County, California",144109,1768,132975,2881,96353,4923,3467,947,129508,2742,36622,4368,11134,2248
"84","06111","Ventura County, California",268524,3070,251024,3530,218219,4514,6906,1205,244118,3424,32805,3209,17500,2268
"85","06113","Yolo County, California",76075,1259,72235,1577,64319,2042,2133,756,70102,1607,7916,1531,3840,1005
"86","06115","Yuba County, California",26827,921,25029,1038,20051,1378,1159,499,23870,1183,4978,1337,1798,648
"87","08001","Adams County, Colorado",171977,1803,163552,2337,136037,3508,5832,1363,157720,2556,27515,2843,8425,1601
"88","08005","Arapahoe County, Colorado",246302,1972,238975,2304,214979,3351,7157,1262,231818,2488,23996,2631,7327,1628
"89","08013","Boulder County, Colorado",131854,2047,128059,2103,119698,2626,3880,965,124179,1987,8361,1492,3795,832
"90","08014","Broomfield County, Colorado",28062,748,27710,774,26887,899,1130,451,26580,886,823,364,352,221
"91","08031","Denver County, Colorado",318445,3441,303632,3530,263199,4765,9551,1826,294081,3989,40433,4254,14813,2095
"92","08035","Douglas County, Colorado",127476,1510,125512,1693,120751,1884,2814,742,122698,1827,4761,1149,1964,820
"93","08041","El Paso County, Colorado",265798,2654,255741,3267,228096,4537,9325,1417,246416,3333,27645,3183,10057,2047
"94","08059","Jefferson County, Colorado",236496,1962,227113,2167,209335,3131,7928,1478,219185,2456,17778,2562,9383,1370
"95","08069","Larimer County, Colorado",146638,1931,143112,2042,131701,2393,5909,1239,137203,2465,11411,2036,3526,835
"96","08077","Mesa County, Colorado",63644,1525,60157,1643,51831,2470,3090,955,57067,1824,8326,1885,3487,805
"97","08101","Pueblo County, Colorado",66111,1293,59409,1592,47148,1954,2860,638,56549,1606,12261,1675,6702,1246
"98","08123","Weld County, Colorado",111298,1402,105970,1759,92721,2285,2524,610,103446,1845,13249,1897,5328,1151
"99","09001","Fairfield County, Connecticut",340557,3374,321363,3942,285852,4386,14883,2373,306480,4742,35511,3093,19194,2282
"100","09003","Hartford County, Connecticut",353234,3169,329943,3919,275335,5170,15440,1904,314503,4482,54608,3309,23291,2245
"101","09005","Litchfield County, Connecticut",73969,2002,68662,2403,61300,2546,4000,929,64662,2395,7362,1379,5307,1042
"102","09007","Middlesex County, Connecticut",66884,2293,62609,2370,54461,2247,4076,1122,58533,2735,8148,1527,4275,1095
"103","09009","New Haven County, Connecticut",329006,3626,301026,4509,250386,3804,14477,2095,286549,4806,50640,3572,27980,2515
"104","09011","New London County, Connecticut",109752,1830,101207,2370,87734,2541,6438,1097,94769,2377,13473,2036,8545,1552
"105","09013","Tolland County, Connecticut",56749,1338,54187,1499,47768,2097,3401,1151,50786,1821,6419,1542,2562,834
"106","09015","Windham County, Connecticut",47015,1253,43420,1520,36522,2004,2645,851,40775,1539,6898,1572,3595,987
"107","10001","Kent County, Delaware",68023,1807,62444,2041,50684,2460,2858,950,59586,2306,11760,2207,5579,1216
"108","10003","New Castle County, Delaware",211592,2204,201867,2880,170777,3838,5970,1150,195897,3122,31090,2839,9725,1626
"109","10005","Sussex County, Delaware",96624,2680,89781,3032,75098,2928,4136,849,85645,3128,14683,2097,6843,1451
"110","11001","District of Columbia, District of Columbia",291570,3959,275282,4813,243222,5228,8310,1460,266972,5129,32060,3817,16288,2526
"111","12001","Alachua County, Florida",103024,2847,99757,2955,83322,3411,2086,733,97671,3032,16435,2852,3267,868
"112","12005","Bay County, Florida",69195,2744,66814,2821,55714,2860,2835,777,63979,2776,11100,2241,2381,779
"113","12009","Brevard County, Florida",230043,4772,216250,5087,193437,5554,12933,1950,203317,5438,22813,3073,13793,2186
"114","12011","Broward County, Florida",705472,7707,671227,8195,571055,8892,17829,2227,653398,8397,100172,4958,34245,3524
"115","12015","Charlotte County, Florida",76589,3272,71391,3668,61047,3341,3654,1041,67737,3905,10344,1667,5198,1412
"116","12017","Citrus County, Florida",64448,2659,59974,2817,51929,2562,4454,1014,55520,3135,8045,1698,4474,999
"117","12019","Clay County, Florida",75793,1945,73301,2007,64372,2648,1420,543,71881,2098,8929,1950,2492,870
"118","12021","Collier County, Florida",140578,5062,134309,4947,111203,5124,6595,1326,127714,5084,23106,2903,6269,1704
"119","12023","Columbia County, Florida",25240,1483,23779,1536,17721,1635,558,357,23221,1567,6058,1347,1461,613
"120","12031","Duval County, Florida",368668,4596,345469,5013,283601,6094,13109,2078,332360,5342,61868,4193,23199,2618
"121","12033","Escambia County, Florida",120618,3101,111469,3385,88870,3331,3755,953,107714,3491,22599,2743,9149,1548
"122","12035","Flagler County, Florida",44464,1735,41917,2047,32038,2165,2428,821,39489,2058,9879,1829,2547,950
"123","12053","Hernando County, Florida",78755,1776,74975,1866,64299,2222,4830,922,70145,2100,10676,1635,3780,948
"124","12055","Highlands County, Florida",43351,2443,38247,2673,30135,2610,2636,861,35611,2811,8112,1491,5104,1244
"125","12057","Hillsborough County, Florida",541584,4189,519751,4367,440052,5468,13879,1622,505872,4646,79699,4659,21833,2577
"126","12061","Indian River County, Florida",63917,2654,59039,2817,50924,2893,3872,993,55167,2808,8115,1804,4878,1182
"127","12069","Lake County, Florida",139192,3527,131313,3838,105429,4266,5950,1394,125363,3677,25884,3887,7879,1953
"128","12071","Lee County, Florida",286887,5798,275502,5737,230692,5680,13019,1897,262483,5872,44810,3261,11385,1584
"129","12073","Leon County, Florida",116283,2781,111627,3154,96917,3471,2363,668,109264,3245,14710,2104,4656,1204
"130","12081","Manatee County, Florida",145171,4572,139180,4777,121086,4912,7227,1197,131953,4903,18094,2341,5991,1343
"131","12083","Marion County, Florida",145622,4007,135983,3860,113578,4498,9530,1770,126453,4178,22405,3224,9639,2285
"132","12085","Martin County, Florida",65014,2055,60758,2182,53656,2593,4762,1283,55996,2240,7102,1669,4256,1293
"133","12086","Miami-Dade County, Florida",912805,5898,856771,6852,696860,8516,18154,2388,838617,7186,159911,7001,56034,4259
"134","12087","Monroe County, Florida",32839,2048,30760,2065,25978,1822,821,366,29939,2098,4782,1279,2079,670
"135","12089","Nassau County, Florida",35212,1465,34619,1466,29907,1718,1979,763,32640,1489,4712,1183,593,354
"136","12091","Okaloosa County, Florida",76097,2603,71478,2594,63206,2794,2930,797,68548,2487,8272,1637,4619,1301
"137","12095","Orange County, Florida",457949,6978,439587,7751,381105,7373,10621,1753,428966,8088,58482,4682,18362,3270
"138","12097","Osceola County, Florida",111539,4304,106353,4491,90640,4552,2879,1176,103474,4633,15713,2812,5186,1535
"139","12099","Palm Beach County, Florida",568915,6021,539146,6531,451740,6967,19619,2051,519527,6526,87406,5386,29769,3346
"140","12101","Pasco County, Florida",212856,4410,201988,4332,173151,4229,11907,1578,190081,4457,28837,3105,10868,1641
"141","12103","Pinellas County, Florida",395286,6581,370429,6470,321376,6579,18289,2251,352140,6443,49053,3814,24857,3484
"142","12105","Polk County, Florida",238629,5267,220047,5362,177146,5467,10533,1428,209514,5299,42901,3855,18582,2326
"143","12107","Putnam County, Florida",30866,1415,26957,1474,19563,1690,1325,466,25632,1521,7394,1604,3909,1067
"144","12109","St. Johns County, Florida",94761,2990,90166,3053,79629,3072,2708,992,87458,3021,10537,2031,4595,1271
"145","12111","St. Lucie County, Florida",116900,4160,111047,3822,92606,3830,4976,1194,106071,3909,18441,2873,5853,1472
"146","12113","Santa Rosa County, Florida",66187,2766,62835,2756,55881,2775,2123,705,60712,2712,6954,1194,3352,1011
"147","12115","Sarasota County, Florida",187411,4122,177404,4428,155480,4398,12090,2260,165314,4481,21924,2614,10007,1698
"148","12117","Seminole County, Florida",181142,2623,175513,2785,154370,4029,3744,902,171769,2866,21143,3167,5629,1037
"149","12119","Sumter County, Florida",59458,3085,57277,3163,50624,3178,4745,1288,52532,3032,6653,1974,2181,726
"150","12127","Volusia County, Florida",219451,3752,209180,3952,170024,4718,9707,1560,199473,4325,39156,3832,10271,1457
"151","12131","Walton County, Florida",26475,2685,25009,2607,20646,2056,424,339,24585,2588,4363,1405,1466,621
"152","13013","Barrow County, Georgia",27765,833,25877,1101,20720,1380,1187,589,24690,1191,5157,1272,1888,698
"153","13015","Bartow County, Georgia",39742,1150,36606,1376,30498,1756,1077,551,35529,1434,6108,1382,3136,1212
"154","13021","Bibb County, Georgia",56726,1984,49968,2401,39088,2313,1488,531,48480,2463,10880,1942,6758,1194
"155","13031","Bulloch County, Georgia",28660,1370,27468,1445,21300,1903,613,492,26855,1493,6168,1417,1192,420
"156","13045","Carroll County, Georgia",42798,1323,39117,1640,30047,2011,1236,684,37881,1890,9070,1838,3681,1071
"157","13047","Catoosa County, Georgia",24130,1401,22382,1448,17896,1458,758,400,21624,1368,4486,1037,1748,782
"158","13051","Chatham County, Georgia",107987,2721,101568,2824,81878,3211,3328,849,98240,2719,19690,2765,6419,1364
"159","13057","Cherokee County, Georgia",93441,1407,87520,1980,81599,2423,3075,1170,84445,2214,5921,1615,5921,1730
"160","13059","Clarke County, Georgia",52124,1282,48693,1832,42862,2470,775,410,47918,1914,5831,1426,3431,1512
"161","13063","Clayton County, Georgia",97030,1802,91332,2046,72050,3235,2499,859,88833,2280,19282,2677,5698,1535
"162","13067","Cobb County, Georgia",286952,3167,281513,3114,253439,4650,5825,1013,275688,3144,28074,3552,5439,1406
"163","13073","Columbia County, Georgia",46890,2705,44740,2519,39960,2642,1173,540,43567,2506,4780,1430,2150,1002
"164","13077","Coweta County, Georgia",53640,1356,51175,1704,41331,2182,1999,745,49176,1818,9844,1598,2465,1071
"165","13089","DeKalb County, Georgia",289829,3342,272285,4384,227321,5492,6766,1279,265519,4210,44964,4076,17544,2662
"166","13095","Dougherty County, Georgia",32630,1314,27410,1389,19818,1940,655,359,26755,1427,7592,1550,5220,1091
"167","13097","Douglas County, Georgia",48899,1680,46299,2236,39603,2534,854,385,45445,2253,6696,1567,2600,1267
"168","13113","Fayette County, Georgia",41253,1092,40358,1140,38381,1277,1391,508,38967,1154,1977,731,895,448
"169","13115","Floyd County, Georgia",35443,1365,31975,1525,24356,1774,1246,521,30729,1539,7619,1597,3468,826
"170","13117","Forsyth County, Georgia",81765,1731,80180,1866,75046,1803,1124,417,79056,1876,5134,1066,1585,675
"171","13121","Fulton County, Georgia",439578,4514,419019,4886,370689,6131,9948,2028,409071,5085,48330,4615,20559,2384
"172","13127","Glynn County, Georgia",34614,1867,30423,1973,24761,2145,1078,601,29345,1941,5662,1419,4191,1386
"173","13135","Gwinnett County, Georgia",301471,3216,290909,3502,261156,5440,5634,1272,285275,3584,29753,3989,10562,1957
"174","13139","Hall County, Georgia",65625,2079,61445,2197,51343,2134,1654,648,59791,2333,10102,1751,4180,1129
"175","13151","Henry County, Georgia",79550,1820,76427,2069,68641,2546,2296,973,74131,2185,7786,1888,3123,957
"176","13153","Houston County, Georgia",58417,1868,54229,2037,45522,2593,1320,713,52909,2048,8707,2181,4188,1270
"177","13157","Jackson County, Georgia",25180,831,22951,1128,19103,1386,793,359,22158,1171,3848,1079,2229,803
"178","13185","Lowndes County, Georgia",42639,1440,38546,1888,28575,1685,1337,547,37209,1994,9971,1877,4093,1264
"179","13215","Muscogee County, Georgia",73134,1814,66651,2166,50789,2536,2086,584,64565,2293,15862,2277,6483,1198
"180","13217","Newton County, Georgia",37867,1008,36159,1188,31220,1661,1009,704,35150,1330,4939,1240,1708,748
"181","13223","Paulding County, Georgia",56476,1811,53844,1980,46813,2637,1546,720,52298,2120,7031,2045,2632,1378
"182","13245","Richmond County, Georgia",68361,3137,62950,3108,46419,3001,2565,910,60385,3074,16531,1993,5411,1126
"183","13247","Rockdale County, Georgia",32792,684,30782,993,25506,1654,1130,502,29652,1094,5276,1356,2010,760
"184","13255","Spalding County, Georgia",25339,994,21744,1419,17846,1680,672,428,21072,1421,3898,1085,3595,1080
"185","13285","Troup County, Georgia",24436,1100,20572,1483,15556,1666,819,574,19753,1553,5016,1181,3864,1238
"186","13295","Walker County, Georgia",26760,1208,23986,1504,18235,1589,1075,445,22911,1493,5751,1362,2774,1077
"187","13297","Walton County, Georgia",33350,1012,30567,1234,25816,1343,760,287,29807,1301,4751,1173,2783,889
"188","13313","Whitfield County, Georgia",34518,1533,30138,2124,23705,1953,1793,732,28345,2164,6433,1519,4380,1383
"189","15001","Hawaii County, Hawaii",71193,2209,64872,2505,53655,2902,3247,1066,61625,2666,11217,1781,6321,1392
"190","15003","Honolulu County, Hawaii",316456,3394,296525,4072,253692,4624,10440,1720,286085,4247,42833,3426,19931,2366
"191","15007","Kauai County, Hawaii",22898,1313,21521,1414,17673,1457,657,279,20864,1459,3848,945,1377,529
"192","15009","Maui County, Hawaii",54744,2300,49732,2612,41760,2613,1545,785,48187,2712,7972,1469,5012,1221
"193","16001","Ada County, Idaho",184160,2215,179493,2441,164215,3743,5701,1523,173792,2726,15278,2551,4667,986
"194","16005","Bannock County, Idaho",32010,947,29733,1158,26069,1282,1782,628,27951,1175,3664,964,2277,620
"195","16019","Bonneville County, Idaho",40776,1151,39199,1217,32404,1562,779,417,38420,1307,6795,1581,1577,515
"196","16027","Canyon County, Idaho",77449,1213,73506,1641,60412,2532,2354,609,71152,1854,13094,2112,3943,1248
"197","16055","Kootenai County, Idaho",65283,1428,62288,1660,52265,2606,3063,1112,59225,1892,10023,1927,2995,825
"198","16083","Twin Falls County, Idaho",31850,1040,29042,1407,23961,1637,1126,490,27916,1401,5081,1257,2808,1037
"199","17001","Adams County, Illinois",26993,1143,23119,1310,19127,1316,1242,406,21877,1310,3992,819,3874,836
"200","17019","Champaign County, Illinois",81764,2599,76881,2774,66837,3181,2456,695,74425,2829,10044,1861,4883,1159
"201","17031","Cook County, Illinois",1985613,7470,1824188,9012,1532432,12497,63824,4314,1760364,10231,291756,9726,161425,5564
"202","17037","DeKalb County, Illinois",39330,1037,37897,1077,31990,1837,1342,445,36555,1154,5907,1456,1433,334
"203","17043","DuPage County, Illinois",342195,2951,327444,3528,295913,4569,10035,1449,317409,3656,31531,2813,14751,1650
"204","17089","Kane County, Illinois",182223,2420,172973,3605,146587,3835,6014,1644,166959,3701,26386,2720,9250,2450
"205","17091","Kankakee County, Illinois",39583,1246,35740,1371,28285,1554,1874,584,33866,1307,7455,1081,3843,870
"206","17093","Kendall County, Illinois",41364,1022,40001,1553,34267,2244,841,539,39160,1548,5734,1717,1363,1074
"207","17097","Lake County, Illinois",247661,2713,236808,3179,208775,3836,7485,1237,229323,2956,28033,2469,10853,1632
"208","17099","LaSalle County, Illinois",45411,1145,39896,1619,31580,1589,2535,658,37361,1600,8316,1080,5515,845
"209","17111","McHenry County, Illinois",112669,1850,108486,2034,97261,2720,3185,693,105301,1970,11225,2192,4183,991
"210","17113","McLean County, Illinois",65118,1761,61593,1967,53757,2267,3265,1015,58328,1967,7836,1634,3525,935
"211","17115","Macon County, Illinois",42741,1439,38457,1610,30349,1786,1885,644,36572,1758,8108,1528,4284,907
"212","17119","Madison County, Illinois",108104,2209,100817,2476,84034,2861,4132,915,96685,2509,16783,2325,7287,1345
"213","17143","Peoria County, Illinois",73666,1750,67406,1998,50614,2530,2348,690,65058,2167,16792,1876,6260,1196
"214","17161","Rock Island County, Illinois",60618,1389,55558,1695,42381,2020,2806,759,52752,1708,13177,1590,5060,1000
"215","17163","St. Clair County, Illinois",106156,2038,96353,2478,75390,3041,3443,834,92910,2691,20963,2694,9803,1981
"216","17167","Sangamon County, Illinois",83263,2028,75936,2157,63712,2737,3187,805,72749,2299,12224,1833,7327,1323
"217","17179","Tazewell County, Illinois",53127,1599,47413,1894,39073,2012,2117,553,45296,1863,8340,1513,5714,1237
"218","17183","Vermilion County, Illinois",31154,1241,27539,1216,19589,1371,2505,660,25034,1432,7950,1466,3615,735
"219","17197","Will County, Illinois",230136,2415,218573,2978,189997,3864,6361,922,212212,2941,28576,2825,11563,1614
"220","17199","Williamson County, Illinois",27650,1173,24645,1293,18823,1271,1011,386,23634,1261,5822,1107,3005,991
"221","17201","Winnebago County, Illinois",114833,2036,106983,2006,83675,2853,4416,963,102567,2091,23308,2667,7850,1192
"222","18003","Allen County, Indiana",146280,2066,137954,2200,113432,2872,6034,1232,131920,2379,24522,2691,8326,1251
"223","18005","Bartholomew County, Indiana",30383,1357,28137,1415,24377,1357,1747,669,26390,1381,3760,896,2246,719
"224","18011","Boone County, Indiana",26803,621,25802,765,22237,1219,932,452,24870,880,3565,1153,1001,561
"225","18019","Clark County, Indiana",43704,1666,40842,1772,32503,1953,2054,646,38788,1883,8339,1346,2862,785
"226","18035","Delaware County, Indiana",45640,1858,40720,2008,31559,1763,1588,614,39132,2016,9161,1476,4920,1095
"227","18039","Elkhart County, Indiana",68553,2110,61823,2031,48916,2448,2702,805,59121,2150,12907,2028,6730,1109
"228","18043","Floyd County, Indiana",28544,1205,26625,1190,21509,1258,873,344,25752,1229,5116,998,1919,456
"229","18053","Grant County, Indiana",27127,1116,23999,1355,18499,1560,1190,525,22809,1329,5500,1209,3128,872
"230","18057","Hamilton County, Indiana",125328,1842,122369,2120,114591,2846,2310,750,120059,2206,7778,2054,2959,971
"231","18059","Hancock County, Indiana",28985,1185,26486,1636,23321,1895,561,422,25925,1663,3165,1091,2499,1045
"232","18063","Hendricks County, Indiana",61105,1414,58935,1586,54237,1734,1445,543,57490,1646,4698,1296,2170,811
"233","18067","Howard County, Indiana",34151,1382,31523,1565,23200,1815,1923,723,29600,1681,8323,1512,2628,835
"234","18081","Johnson County, Indiana",57160,1778,53821,1838,46141,2260,1788,681,52033,1951,7680,2057,3339,811
"235","18085","Kosciusko County, Indiana",30991,1563,27752,1619,22484,1359,2022,765,25730,1727,5268,1124,3239,923
"236","18089","Lake County, Indiana",190135,3000,172786,3566,134676,3826,7614,1206,165172,3671,38110,3365,17349,2192
"237","18091","LaPorte County, Indiana",43100,1560,39379,1876,31192,1690,1882,585,37497,1934,8187,1461,3721,787
"238","18095","Madison County, Indiana",51164,1512,46350,1935,35513,2283,2816,767,43534,2030,10837,1568,4814,1089
"239","18097","Marion County, Indiana",379451,3928,337302,5402,269549,5550,14188,2072,323114,5907,67753,4327,42149,4284
"240","18105","Monroe County, Indiana",54053,1871,51267,2057,44453,2515,1647,628,49620,2144,6814,1605,2786,1011
"241","18109","Morgan County, Indiana",25863,1094,24259,1207,20019,1317,1127,439,23132,1240,4240,998,1604,469
"242","18127","Porter County, Indiana",65305,1477,62120,1734,52853,2034,2066,632,60054,1824,9267,1677,3185,909
"243","18141","St. Joseph County, Indiana",105250,2172,95384,2750,76894,2943,4886,851,90498,2826,18490,2103,9866,1464
"244","18157","Tippecanoe County, Indiana",73916,1531,69648,1873,50892,2600,1225,550,68423,2001,18756,2508,4268,1247
"245","18163","Vanderburgh County, Indiana",75522,1922,69294,2459,54664,2697,3358,832,65936,2395,14630,1959,6228,1234
"246","18167","Vigo County, Indiana",42193,1619,39212,1727,29735,1845,1683,494,37529,1780,9477,1662,2981,680
"247","18177","Wayne County, Indiana",27561,1110,24970,1280,19986,1486,1331,468,23639,1265,4984,1116,2591,648
"248","19013","Black Hawk County, Iowa",51869,1664,48326,1797,39126,2053,2241,551,46085,1897,9200,1449,3543,736
"249","19049","Dallas County, Iowa",36878,1003,35043,1230,31012,1679,568,242,34475,1257,4031,1419,1835,512
"250","19061","Dubuque County, Iowa",38345,1198,35883,1277,28600,1552,2068,600,33815,1379,7283,1297,2462,587
"251","19103","Johnson County, Iowa",60782,1869,57749,1996,52397,2192,2160,603,55589,2036,5352,1227,3033,843
"252","19113","Linn County, Iowa",93843,1458,88755,1658,75443,2488,3917,959,84838,1919,13312,2021,5088,989
"253","19153","Polk County, Iowa",197731,2137,184796,2689,155048,3259,7230,1402,177566,3113,29748,2713,12935,1791
"254","19155","Pottawattamie County, Iowa",37344,950,34759,1171,28174,1377,2187,783,32572,1374,6585,1090,2585,622
"255","19163","Scott County, Iowa",68534,1573,61414,1795,51897,2052,2470,605,58944,1751,9517,1423,7120,1151
"256","19169","Story County, Iowa",39168,1083,37360,1248,34706,1445,1793,566,35567,1337,2654,711,1808,694
"257","19193","Woodbury County, Iowa",39733,1064,35789,1426,28739,1557,1665,521,34124,1416,7050,1079,3944,1163
"258","20015","Butler County, Kansas",25004,1070,23154,1228,20291,1221,449,314,22705,1285,2863,741,1850,683
"259","20045","Douglas County, Kansas",48508,1329,47990,1365,42005,2102,1067,557,46923,1516,5985,1489,518,324
"260","20091","Johnson County, Kansas",231960,2823,224696,2876,210189,3415,7782,1239,216914,2996,14507,1909,7264,1364
"261","20103","Leavenworth County, Kansas",27860,1080,26559,1137,23339,1312,1218,477,25341,1298,3220,915,1301,522
"262","20161","Riley County, Kansas",25662,1547,24449,1709,22372,1759,1214,568,23235,1642,2077,721,1213,703
"263","20173","Sedgwick County, Kansas",199517,3251,186930,3401,151199,3534,6610,1073,180320,3421,35731,3083,12587,1709
"264","20177","Shawnee County, Kansas",73172,1641,65881,1936,53740,2039,3926,922,61955,1909,12141,1586,7291,1346
"265","20209","Wyandotte County, Kansas",61248,1463,55567,1648,40667,2405,2926,681,52641,1685,14900,1870,5681,1003
"266","21015","Boone County, Kentucky",48770,957,47154,1179,40595,1829,2128,661,45026,1227,6559,1691,1616,643
"267","21029","Bullitt County, Kentucky",30553,893,28544,1071,22114,1576,860,311,27684,1074,6430,1293,2009,569
"268","21037","Campbell County, Kentucky",38110,1075,34477,1475,28977,1461,1378,492,33099,1423,5500,982,3633,1085
"269","21047","Christian County, Kentucky",26209,1244,24061,1246,19062,1576,617,415,23444,1294,4999,1219,2148,650
"270","21059","Daviess County, Kentucky",40800,1022,37888,1224,29140,1565,1641,596,36247,1262,8748,1548,2912,820
"271","21067","Fayette County, Kentucky",131929,2303,125102,2558,106497,2961,3577,733,121525,2526,18605,2525,6827,1570
"272","21093","Hardin County, Kentucky",42644,1324,39607,1629,31559,2073,1597,575,38010,1583,8048,1384,3037,1054
"273","21111","Jefferson County, Kentucky",316174,3159,293462,3539,232628,4833,11085,1594,282377,3725,60834,3992,22712,2516
"274","21117","Kenton County, Kentucky",65362,1218,61460,1460,51403,1978,2337,707,59123,1555,10057,1717,3902,931
"275","21145","McCracken County, Kentucky",28363,1234,26488,1380,23227,1447,1159,513,25329,1383,3261,732,1875,695
"276","21151","Madison County, Kentucky",34270,1339,31867,1693,24942,1977,998,462,30869,1773,6925,1233,2403,879
"277","21185","Oldham County, Kentucky",20761,704,19956,768,18130,868,399,216,19557,726,1826,672,805,386
"278","21227","Warren County, Kentucky",50489,1542,46980,1757,38802,2129,1459,618,45521,1882,8178,1659,3509,1181
"279","22005","Ascension Parish, Louisiana",44267,1708,41550,2119,35611,2334,612,448,40938,2127,5939,1546,2717,1171
"280","22015","Bossier Parish, Louisiana",49735,2024,46561,2223,34694,2486,1829,553,44732,2187,11867,2135,3174,924
"281","22017","Caddo Parish, Louisiana",92589,2930,80929,3223,53570,3687,2274,706,78655,3321,27359,2816,11660,1908
"282","22019","Calcasieu Parish, Louisiana",77232,2497,70046,2693,54432,3485,3659,1167,66387,2862,15614,2639,7186,1347
"283","22033","East Baton Rouge Parish, Louisiana",161536,4003,151297,4235,119677,4083,3494,737,147803,4198,31620,3025,10239,1899
"284","22045","Iberia Parish, Louisiana",26185,1465,22574,1743,12801,1527,932,523,21642,1819,9773,1807,3611,977
"285","22051","Jefferson Parish, Louisiana",171991,2177,157864,2765,123383,3917,6450,1017,151414,2926,34481,3159,14127,2330
"286","22055","Lafayette Parish, Louisiana",94490,2243,87186,2704,72216,3246,2040,904,85146,2750,14970,2586,7304,1723
"287","22057","Lafourche Parish, Louisiana",36759,1475,31796,1881,23616,2047,1081,530,30715,1856,8180,1683,4963,1173
"288","22063","Livingston Parish, Louisiana",47014,2544,44331,2980,33228,3135,1171,648,43160,2964,11103,2295,2683,1156
"289","22071","Orleans Parish, Louisiana",151753,2527,136923,2721,101413,3118,3624,880,133299,2789,35510,2910,14830,1477
"290","22073","Ouachita Parish, Louisiana",57835,2302,48982,2541,36122,2244,1342,466,47640,2546,12860,2072,8853,1666
"291","22079","Rapides Parish, Louisiana",48975,1955,42346,1876,30975,1916,1245,562,41101,1868,11371,1733,6629,1393
"292","22097","St. Landry Parish, Louisiana",30441,1365,23083,1685,15085,1617,1171,415,21912,1714,7998,1371,7358,1525
"293","22103","St. Tammany Parish, Louisiana",94988,2737,89410,2731,77958,2962,1808,483,87602,2806,11452,2003,5578,1278
"294","22105","Tangipahoa Parish, Louisiana",46526,2273,42415,2386,31668,2575,1539,604,40876,2396,10747,2157,4111,1143
"295","22109","Terrebonne Parish, Louisiana",40173,1553,35947,1906,26619,2159,803,461,35144,1985,9328,1933,4226,1024
"296","23001","Androscoggin County, Maine",45924,1374,42583,1559,36146,1915,2126,698,40457,1628,6437,1262,3341,929
"297","23003","Aroostook County, Maine",30197,1212,25877,1320,19760,1230,2723,644,23154,1290,6117,1017,4320,859
"298","23005","Cumberland County, Maine",124925,2563,117587,2902,104352,3338,5998,1177,111589,3017,13235,2081,7338,1592
"299","23011","Kennebec County, Maine",54480,1522,49990,1597,42564,1697,3347,889,46643,1838,7426,1327,4490,935
"300","23019","Penobscot County, Maine",64096,1680,58627,1927,48374,2265,4101,895,54526,2065,10253,1493,5469,1074
"301","23031","York County, Maine",86227,2684,80855,2884,70197,2815,6014,1348,74841,3132,10658,2211,5372,1238
"302","24001","Allegany County, Maryland",26549,1492,22339,1518,17613,1552,1414,330,20925,1489,4726,1102,4210,738
"303","24003","Anne Arundel County, Maryland",216200,2680,208744,3341,190628,4131,7322,1422,201422,3720,18116,2635,7456,1762
"304","24005","Baltimore County, Maryland",312466,3553,291446,4303,257104,4551,14334,1808,277112,4260,34342,3690,21020,2780
"305","24009","Calvert County, Maryland",32780,1120,31637,1204,29158,1245,1184,526,30453,1283,2479,999,1143,523
"306","24013","Carroll County, Maryland",60617,1215,56858,1371,50386,1580,2789,574,54069,1434,6472,1461,3759,703
"307","24015","Cecil County, Maryland",38547,1614,36188,1666,30883,1742,1417,568,34771,1770,5305,1186,2359,813
"308","24017","Charles County, Maryland",57732,1218,54231,1485,49695,1738,2434,820,51797,1424,4536,1328,3501,951
"309","24021","Frederick County, Maryland",93768,1685,89206,1727,81545,2261,2943,734,86263,1706,7661,1597,4562,1004
"310","24025","Harford County, Maryland",96203,1592,92337,1604,82749,2383,2876,565,89461,1668,9588,1799,3866,839
"311","24027","Howard County, Maryland",115772,2010,111999,2193,104766,2411,2732,756,109267,2432,7233,1649,3773,1195
"312","24031","Montgomery County, Maryland",368897,3465,360014,3575,334317,4076,12995,1983,347019,3708,25697,2424,8883,1828
"313","24033","Prince George's County, Maryland",316361,2616,302533,2877,255653,4393,9090,1580,293443,3068,46880,3706,13828,2031
"314","24037","St. Mary's County, Maryland",40320,1645,37121,1862,32490,2257,1883,802,35238,2021,4631,1373,3199,1074
"315","24043","Washington County, Maryland",56225,1753,51479,1825,39578,2116,3013,783,48466,1939,11901,1576,4746,880
"316","24045","Wicomico County, Maryland",38088,1669,34861,1761,29344,2116,1831,623,33030,1873,5517,1390,3227,710
"317","24510","Baltimore city, Maryland",242694,3666,215019,4671,163746,5134,8599,1853,206420,4645,51273,3628,27675,2981
"318","25001","Barnstable County, Massachusetts",96509,3685,92340,3658,82940,3919,4462,860,87878,3667,9400,1554,4169,867
"319","25003","Berkshire County, Massachusetts",53792,1705,48849,1686,41662,2069,3504,967,45345,1851,7187,1611,4943,1093
"320","25005","Bristol County, Massachusetts",220528,2392,198367,2876,162914,3771,11670,1848,186697,3372,35453,3530,22161,2088
"321","25009","Essex County, Massachusetts",297898,2897,279031,3701,231504,4803,12176,1622,266855,3996,47527,4115,18867,2555
"322","25011","Franklin County, Massachusetts",30927,954,28373,1025,23542,1352,2418,628,25955,1195,4831,1144,2554,604
"323","25013","Hampden County, Massachusetts",179970,2207,161125,2820,122214,3310,9770,1745,151355,3036,38911,3109,18845,2371
"324","25015","Hampshire County, Massachusetts",60002,1623,57143,1767,52025,1997,3423,788,53720,1986,5118,1148,2859,753
"325","25017","Middlesex County, Massachusetts",612366,4465,579271,5048,530849,6250,22216,2333,557055,5549,48422,4189,33095,3296
"326","25021","Norfolk County, Massachusetts",269717,2770,257856,3051,233440,3801,10017,1518,247839,3437,24416,2730,11861,1865
"327","25023","Plymouth County, Massachusetts",191041,3246,181371,3329,157510,3578,10262,1697,171109,3694,23861,3098,9670,1603
"328","25025","Suffolk County, Massachusetts",309945,4119,287024,4807,243609,5105,8508,1340,278516,5024,43415,3664,22921,2617
"329","25027","Worcester County, Massachusetts",316162,2896,295632,3526,251172,5359,12650,1635,282982,3781,44460,3895,20530,2054
"330","26005","Allegan County, Michigan",43667,1438,39437,1774,32875,1825,877,362,38560,1801,6562,1309,4230,1066
"331","26017","Bay County, Michigan",44887,1117,41281,1318,34110,1780,2825,691,38456,1485,7171,1282,3606,928
"332","26021","Berrien County, Michigan",61809,2093,55401,2124,44165,2288,2579,591,52822,2082,11236,1559,6408,1254
"333","26025","Calhoun County, Michigan",53827,1840,47978,2024,37171,1899,3222,711,44756,1979,10807,1312,5849,980
"334","26037","Clinton County, Michigan",30070,692,28093,903,23272,1198,1080,336,27013,912,4821,1054,1977,535
"335","26045","Eaton County, Michigan",44420,1034,41265,1180,35165,1244,1988,490,39277,1329,6100,910,3155,681
"336","26049","Genesee County, Michigan",169247,2251,153970,2987,120784,3079,8011,1333,145959,2987,33186,2741,15277,1878
"337","26055","Grand Traverse County, Michigan",37408,1903,35087,2088,30586,2060,1367,539,33720,2164,4501,1003,2321,824
"338","26065","Ingham County, Michigan",114534,1819,107962,2092,88071,2508,3876,845,104086,2257,19891,2024,6572,1123
"339","26073","Isabella County, Michigan",24690,969,23090,983,19173,1190,1143,396,21947,983,3917,706,1600,320
"340","26075","Jackson County, Michigan",61403,1713,54849,2036,42243,2108,2654,703,52195,2115,12606,1651,6554,1254
"341","26077","Kalamazoo County, Michigan",103196,2059,97298,2426,81553,2754,3831,713,93467,2597,15745,1984,5898,1191
"342","26081","Kent County, Michigan",245437,2516,230582,3303,192809,4306,8734,1413,221848,3576,37773,3496,14855,2015
"343","26087","Lapeer County, Michigan",33902,1026,31891,1082,26343,1322,1131,406,30760,1185,5548,1068,2011,539
"344","26091","Lenawee County, Michigan",38499,1322,35610,1416,27564,1451,1197,420,34413,1373,8046,1235,2889,732
"345","26093","Livingston County, Michigan",73502,1213,69579,1443,61095,1900,2354,492,67225,1597,8484,1527,3923,983
"346","26099","Macomb County, Michigan",351666,2850,330365,3237,275556,4382,14495,1774,315870,3353,54809,3479,21301,2240
"347","26103","Marquette County, Michigan",27981,1092,25875,1144,21899,1330,1714,646,24161,1244,3976,1058,2106,506
"348","26111","Midland County, Michigan",34350,934,31805,984,27336,1327,1099,413,30706,1021,4469,885,2545,704
"349","26115","Monroe County, Michigan",60875,1293,56347,1748,45635,1937,3034,742,53313,1653,10712,1606,4528,1148
"350","26121","Muskegon County, Michigan",66148,1782,57732,2175,44053,1993,2966,818,54766,2212,13679,1501,8416,1406
"351","26125","Oakland County, Michigan",508464,3628,485531,4185,431230,5042,17589,1868,467942,4585,54301,3507,22933,2094
"352","26139","Ottawa County, Michigan",105004,1614,99721,1918,83257,2903,3882,930,95839,2058,16464,2251,5283,968
"353","26145","Saginaw County, Michigan",79050,2036,71206,2257,54334,2093,4178,969,67028,2384,16872,2214,7844,1316
"354","26147","St. Clair County, Michigan",63806,1836,58308,2002,46082,2090,3186,734,55122,2116,12226,1619,5498,914
"355","26155","Shiawassee County, Michigan",26830,976,24000,1069,19533,1166,974,347,23026,1154,4467,820,2830,608
"356","26159","Van Buren County, Michigan",30974,1335,28814,1370,22443,1320,1846,585,26968,1350,6371,1005,2160,643
"357","26161","Washtenaw County, Michigan",141680,2021,137260,2356,125055,2742,4196,1001,133064,2630,12205,1490,4420,944
"358","26163","Wayne County, Michigan",689270,6025,626749,6478,470260,7617,27089,2034,599660,6449,156489,6268,62521,3804
"359","27003","Anoka County, Minnesota",131858,1128,126816,1540,111803,2089,6173,1152,120643,1844,15013,1682,5042,1060
"360","27013","Blue Earth County, Minnesota",26461,1018,24961,1147,22165,1468,1448,440,23513,1231,2796,907,1500,540
"361","27019","Carver County, Minnesota",38860,520,36948,876,33813,1055,457,252,36491,879,3135,857,1912,602
"362","27035","Crow Wing County, Minnesota",28012,1060,25894,1103,21636,1150,1257,412,24637,1144,4258,772,2118,594
"363","27037","Dakota County, Minnesota",162895,1622,156840,2074,140851,2989,5623,1065,151217,2177,15989,2375,6055,1183
"364","27053","Hennepin County, Minnesota",517091,3530,492930,3882,438332,5097,17101,2006,475829,4328,54598,3638,24161,2452
"365","27109","Olmsted County, Minnesota",65635,1105,62367,1441,55057,1703,3526,909,58841,1550,7310,1196,3268,835
"366","27123","Ramsey County, Minnesota",206124,2501,192351,2932,163985,3746,7321,1064,185030,2763,28366,2851,13773,1667
"367","27131","Rice County, Minnesota",22861,976,21019,1053,17848,1243,927,342,20092,1088,3171,737,1842,598
"368","27137","St. Louis County, Minnesota",86448,1761,78667,2011,64295,2254,3813,747,74854,2185,14372,1708,7781,1102
"369","27139","Scott County, Minnesota",51474,737,49759,1033,45226,1622,1559,576,48200,1142,4533,1410,1715,738
"370","27141","Sherburne County, Minnesota",32686,1147,30998,1325,27472,1458,1263,555,29735,1348,3526,1112,1688,532
"371","27145","Stearns County, Minnesota",59776,1417,54961,1564,45004,1885,2801,671,52160,1575,9957,1389,4815,880
"372","27163","Washington County, Minnesota",97059,1292,91875,1819,83199,2147,3406,797,88469,1805,8676,1564,5184,1189
"373","27171","Wright County, Minnesota",49443,962,46795,1161,41336,1498,1523,511,45272,1181,5459,1265,2648,804
"374","28033","DeSoto County, Mississippi",65220,1823,61702,2087,51042,2700,2160,704,59542,2071,10660,1903,3518,1036
"375","28035","Forrest County, Mississippi",27340,1423,24457,1549,17968,1605,927,653,23530,1625,6489,1551,2883,976
"376","28047","Harrison County, Mississippi",74628,3132,68578,3282,52742,3497,1519,464,67059,3265,15836,2537,6050,1480
"377","28049","Hinds County, Mississippi",88471,2331,78791,2698,56081,2869,2014,627,76777,2742,22710,2577,9680,1543
"378","28059","Jackson County, Mississippi",56323,1633,50705,2053,39163,2417,823,325,49882,2131,11542,2133,5618,1542
"379","28067","Jones County, Mississippi",24178,1324,21029,1328,11136,1714,783,520,20246,1369,9893,1604,3149,805
"380","28075","Lauderdale County, Mississippi",29367,1473,26709,1529,17058,1722,1075,624,25634,1537,9651,1430,2658,811
"381","28081","Lee County, Mississippi",30378,1367,26778,1524,19295,1661,499,290,26279,1591,7483,1340,3600,971
"382","28089","Madison County, Mississippi",40046,1379,37830,1365,31305,1806,862,465,36968,1433,6525,1529,2216,751
"383","28121","Rankin County, Mississippi",57011,1738,53393,2022,44754,2455,1569,810,51824,2284,8639,1835,3618,1010
"384","29019","Boone County, Missouri",70721,2156,66958,2330,58185,2953,2588,862,64370,2474,8773,2016,3763,1064
"385","29021","Buchanan County, Missouri",33984,1323,30253,1565,20796,1628,1316,546,28937,1542,9457,1529,3731,969
"386","29031","Cape Girardeau County, Missouri",31335,1111,29151,1221,23354,1549,1455,679,27696,1372,5797,1062,2184,740
"387","29037","Cass County, Missouri",40544,1168,39294,1329,33203,1830,942,483,38352,1357,6091,1233,1250,512
"388","29043","Christian County, Missouri",33227,916,31908,1058,25368,1567,725,318,31183,1060,6540,1419,1319,568
"389","29047","Clay County, Missouri",93066,1893,89544,2081,74757,2649,3203,897,86341,2129,14787,2270,3522,1257
"390","29051","Cole County, Missouri",31437,1226,29207,1348,23510,1988,1347,742,27860,1548,5697,1680,2230,727
"391","29071","Franklin County, Missouri",42161,1138,37862,1562,30645,1665,1531,545,36331,1577,7217,1353,4299,1140
"392","29077","Greene County, Missouri",133900,1384,115272,2937,96753,3654,4815,1048,110457,3075,18519,2181,18628,2812
"393","29095","Jackson County, Missouri",292571,3126,272459,3276,216644,4410,9952,1359,262507,3423,55815,3816,20112,2375
"394","29097","Jasper County, Missouri",45019,1834,40785,2166,30550,2145,1454,665,39331,2144,10235,1668,4234,1145
"395","29099","Jefferson County, Missouri",83841,2086,78672,2343,65194,2312,3381,1071,75291,2424,13478,1889,5169,1144
"396","29165","Platte County, Missouri",40332,1003,38921,1251,34109,1547,321,203,38600,1276,4812,1140,1411,657
"397","29183","St. Charles County, Missouri",150668,1761,144849,2126,132102,2629,6151,1192,138698,2333,12747,2032,5819,1313
"398","29187","St. Francois County, Missouri",24021,1390,22074,1595,15611,1687,889,498,21185,1694,6463,1241,1947,783
"399","29189","St. Louis County, Missouri",410842,3458,386642,4247,326862,5214,15999,1925,370643,4605,59780,4500,24200,2587
"400","29510","St. Louis city, Missouri",146779,3107,131114,3250,102000,3935,5042,890,126072,3244,29114,2774,15665,2070
"401","30013","Cascade County, Montana",32816,1153,28949,1468,23032,1553,1695,508,27254,1540,5917,1139,3867,907
"402","30029","Flathead County, Montana",40681,1861,38354,1883,33471,2040,1286,473,37068,1901,4883,996,2327,816
"403","30031","Gallatin County, Montana",46990,1210,44511,1713,41487,1787,1219,569,43292,1785,3024,917,2479,1018
"404","30049","Lewis and Clark County, Montana",27405,1310,25828,1454,22660,1529,1557,613,24271,1524,3168,839,1577,565
"405","30063","Missoula County, Montana",50853,1509,48679,1646,41731,1913,1938,616,46741,1742,6948,1524,2174,709
"406","30111","Yellowstone County, Montana",69989,1402,66059,1455,54255,2471,3451,833,62608,1585,11804,2117,3930,943
"407","31055","Douglas County, Nebraska",222819,2301,209015,2804,176345,3126,7829,1080,201186,2919,32670,2468,13804,1733
"408","31109","Lancaster County, Nebraska",128385,2109,123011,2277,108803,2972,4610,789,118401,2376,14208,2259,5374,1017
"409","31153","Sarpy County, Nebraska",68947,914,66346,1165,60562,1492,1679,464,64667,1213,5784,1196,2601,751
"410","32003","Clark County, Nevada",813607,7174,767327,7212,632647,8200,31617,2909,735710,7421,134680,5636,46280,3754
"411","32031","Washoe County, Nevada",191091,2296,182498,2672,159760,3439,6572,1200,175926,2827,22738,2760,8593,1244
"412","33005","Cheshire County, New Hampshire",29698,1434,27244,1335,23119,1269,1128,404,26116,1452,4125,1023,2454,749
"413","33009","Grafton County, New Hampshire",35780,1865,31861,1883,29479,1896,2569,682,29292,1937,2382,602,3919,969
"414","33011","Hillsborough County, New Hampshire",162588,2111,154987,2503,137123,3497,7704,1547,147283,2847,17864,2555,7601,1305
"415","33013","Merrimack County, New Hampshire",60017,1417,55308,1854,48822,2126,3142,914,52166,1802,6486,1325,4709,1300
"416","33015","Rockingham County, New Hampshire",124212,1993,118143,2405,106457,2910,5645,1305,112498,2515,11686,2041,6069,1249
"417","33017","Strafford County, New Hampshire",50584,1387,46523,1616,40536,2100,1971,688,44552,1738,5987,1614,4061,949
"418","34001","Atlantic County, New Jersey",101975,2606,94694,2561,80374,3291,4008,905,90686,2486,14320,2090,7281,1317
"419","34003","Bergen County, New Jersey",343733,2437,325310,3552,291554,4109,11370,1542,313940,3508,33756,3133,18423,2666
"420","34005","Burlington County, New Jersey",170074,2140,160735,2571,145519,2763,6973,1413,153762,2758,15216,1752,9339,1501
"421","34007","Camden County, New Jersey",187780,2647,173888,2894,144700,3818,7458,1172,166430,3043,29188,2791,13892,1758
"422","34009","Cape May County, New Jersey",40939,2313,38132,2394,32547,2542,2434,670,35698,2443,5585,1246,2807,864
"423","34011","Cumberland County, New Jersey",51360,1392,45854,1557,36062,2179,2226,685,43628,1618,9792,2009,5506,1050
"424","34013","Essex County, New Jersey",295976,2242,271418,3246,213664,4470,7080,1296,264338,3239,57754,3931,24558,2500
"425","34015","Gloucester County, New Jersey",106705,1808,99222,2244,86410,2876,5205,1045,94017,2226,12812,2061,7483,1492
"426","34017","Hudson County, New Jersey",266664,2722,252119,3348,211101,4259,4479,878,247640,3278,41018,3531,14545,2065
"427","34019","Hunterdon County, New Jersey",47901,1312,45177,1457,42547,1685,2705,795,42472,1427,2630,793,2724,945
"428","34021","Mercer County, New Jersey",130851,2539,122207,2692,101529,3282,5123,1069,117084,2699,20678,2480,8644,1786
"429","34023","Middlesex County, New Jersey",285906,2165,269765,3295,241245,4348,9226,1624,260539,3539,28520,3096,16141,2281
"430","34025","Monmouth County, New Jersey",240377,2681,228154,3432,205296,4322,8542,1290,219612,3345,22858,2855,12223,1910
"431","34027","Morris County, New Jersey",184885,2391,176927,2853,163297,3316,7526,1244,169401,2900,13630,2143,7958,1394
"432","34029","Ocean County, New Jersey",226725,3469,208593,3907,186498,4578,15876,2027,192717,4108,22095,2521,18132,2295
"433","34031","Passaic County, New Jersey",168059,1590,154739,2183,127492,2810,5019,899,149720,2326,27247,2491,13320,1826
"434","34033","Salem County, New Jersey",24404,833,22540,894,18049,1092,1435,485,21105,1014,4491,962,1864,483
"435","34035","Somerset County, New Jersey",122606,1631,118933,1868,108541,2262,3313,740,115620,2050,10392,1876,3673,854
"436","34037","Sussex County, New Jersey",54099,1969,51654,2092,47706,2015,2864,670,48790,2155,3948,724,2445,800
"437","34039","Union County, New Jersey",192848,1974,178013,2895,149133,3516,5860,1223,172153,3047,28880,2967,14835,2037
"438","34041","Warren County, New Jersey",42397,1033,39257,1361,34177,1562,2315,668,36942,1327,5080,1172,3140,906
"439","35001","Bernalillo County, New Mexico",271307,3383,251664,4027,206997,5025,8410,1431,243254,4104,44667,4087,19643,2529
"440","35005","Chaves County, New Mexico",24671,1016,20862,1439,14889,1474,1116,455,19746,1405,5973,1140,3809,1000
"441","35013","Doña Ana County, New Mexico",79094,2411,71252,2714,54533,3003,2484,798,68768,2884,16719,2318,7842,1615
"442","35025","Lea County, New Mexico",24478,879,21810,1119,16340,1321,489,342,21321,1080,5470,1285,2668,955
"443","35031","McKinley County, New Mexico",21719,821,14565,1248,9051,1167,563,296,14002,1188,5514,997,7154,1061
"444","35035","Otero County, New Mexico",24133,1355,22188,1442,16459,1614,930,408,21258,1360,5729,1196,1945,741
"445","35043","Sandoval County, New Mexico",53251,1135,50223,1209,44747,1685,1516,531,48707,1263,5476,1152,3028,507
"446","35045","San Juan County, New Mexico",42561,1448,35168,1605,27560,1662,1145,491,34023,1699,7608,1277,7393,1002
"447","35049","Santa Fe County, New Mexico",62182,1949,56915,2169,47616,2165,2577,733,54338,2102,9299,1490,5267,1118
"448","35061","Valencia County, New Mexico",24829,1509,20863,1450,17687,1499,1531,647,19332,1542,3176,1060,3966,970
"449","36001","Albany County, New York",128284,2411,119240,2977,103283,3357,6361,1264,112879,3016,15957,2218,9044,1606
"450","36005","Bronx County, New York",513890,3258,461489,5375,317330,6696,14514,1470,446975,5750,144159,7177,52401,4261
"451","36007","Broome County, New York",79309,1979,72260,2258,59014,2410,4521,1091,67739,2583,13246,1870,7049,1100
"452","36009","Cattaraugus County, New York",33056,1001,27797,1233,21214,1258,1988,390,25809,1281,6583,848,5259,784
"453","36011","Cayuga County, New York",31489,1126,28209,1155,22911,1356,1831,428,26378,1111,5298,1003,3280,564
"454","36013","Chautauqua County, New York",55345,1629,48994,1945,38216,2176,3784,959,45210,2043,10778,1666,6351,989
"455","36015","Chemung County, New York",33490,1396,30053,1491,25542,1477,2413,816,27640,1468,4511,1007,3437,837
"456","36019","Clinton County, New York",31422,1523,27998,1590,24205,1596,2219,742,25779,1719,3793,918,3424,899
"457","36027","Dutchess County, New York",110529,2070,104193,2396,90140,2658,4996,1146,99197,2452,14053,2358,6336,1494
"458","36029","Erie County, New York",398326,4131,362095,4953,299218,5945,20999,2250,341096,5293,62877,4156,36231,3317
"459","36045","Jefferson County, New York",41214,1788,37630,1833,30966,1993,1661,475,35969,1850,6664,1345,3584,924
"460","36047","Kings County, New York",978091,5532,883057,6045,750531,7741,30904,2115,852153,6331,132526,6675,95034,4856
"461","36051","Livingston County, New York",23409,1202,21654,1246,18182,1386,1457,453,20197,1262,3472,771,1755,462
"462","36053","Madison County, New York",25986,1167,24027,1238,21353,1278,1450,484,22577,1353,2674,673,1959,681
"463","36055","Monroe County, New York",305284,3207,281486,3861,233715,4908,14894,1702,266592,3772,47771,3077,23798,2210
"464","36059","Nassau County, New York",449798,2410,429037,2978,386065,5631,15428,1769,413609,3060,42972,4368,20761,2094
"465","36061","New York County, New York",768203,9298,709547,9890,630677,10545,17717,2892,691830,10477,78870,6236,58656,5033
"466","36063","Niagara County, New York",90625,1943,82273,2328,65934,2547,3711,795,78562,2303,16339,2117,8352,1352
"467","36065","Oneida County, New York",90273,1959,81531,2496,66235,2288,4853,911,76678,2468,15296,2002,8742,1481
"468","36067","Onondaga County, New York",183218,3028,165009,3455,138430,3480,8827,1362,156182,3537,26579,2700,18209,2289
"469","36069","Ontario County, New York",46025,1459,42785,1621,37354,1582,2511,559,40274,1711,5431,1136,3240,922
"470","36071","Orange County, New York",131421,2722,120336,2966,103476,3257,5137,1077,115199,2972,16860,2203,11085,1618
"471","36075","Oswego County, New York",46640,1468,42360,1767,35203,2067,2702,783,39658,1958,7157,1528,4280,993
"472","36079","Putnam County, New York",34470,1417,33174,1553,29764,1492,1155,475,32019,1584,3410,948,1296,483
"473","36081","Queens County, New York",784552,4746,726624,5267,602230,6868,23901,1876,702723,5603,124394,5736,57928,4019
"474","36083","Rensselaer County, New York",65790,1562,60995,1709,52222,2031,3576,761,57419,1776,8773,1739,4795,881
"475","36085","Richmond County, New York",166297,2678,154413,2917,132470,3415,5024,1053,149389,3280,21943,3124,11884,1882
"476","36087","Rockland County, New York",101424,1321,91711,1913,82558,2257,6856,1196,84855,2171,9153,1679,9713,1370
"477","36089","St. Lawrence County, New York",42832,1430,37467,1561,28889,1792,1770,545,35697,1532,8578,1284,5365,984
"478","36091","Saratoga County, New York",93547,2226,88693,2306,78873,2461,4226,966,84467,2391,9820,1711,4854,959
"479","36093","Schenectady County, New York",62534,1508,57726,1718,47393,2287,4014,901,53712,1886,10333,1941,4808,1156
"480","36101","Steuben County, New York",39283,1536,35221,1556,28636,1492,2631,548,32590,1549,6585,942,4062,564
"481","36103","Suffolk County, New York",499744,4104,475496,5000,436539,5939,22896,2539,452600,5186,38957,3289,24248,2584
"482","36105","Sullivan County, New York",28960,1694,26532,1740,21376,1567,2343,814,24189,1778,5156,1189,2428,747
"483","36109","Tompkins County, New York",40322,1657,38387,1774,35143,1935,1656,554,36731,1893,3244,852,1935,808
"484","36111","Ulster County, New York",69376,2070,64026,2196,54428,2389,4087,1010,59939,2380,9598,1518,5350,1321
"485","36113","Warren County, New York",29593,1551,27242,1559,23353,1687,1784,562,25458,1554,3889,996,2351,581
"486","36117","Wayne County, New York",36634,1245,33348,1251,26714,1306,2439,614,30909,1406,6634,1196,3286,806
"487","36119","Westchester County, New York",355136,3238,332982,3891,294956,5500,12705,1820,320277,3934,38026,3790,22154,2768
"488","37001","Alamance County, North Carolina",64316,1763,59120,2215,46960,2530,2397,656,56723,2202,12160,1928,5196,1224
"489","37019","Brunswick County, North Carolina",58385,2550,56983,2552,48285,2392,2821,767,54162,2650,8698,1869,1402,487
"490","37021","Buncombe County, North Carolina",106741,3462,96190,3449,80365,3471,4299,923,91891,3312,15825,2740,10551,1754
"491","37023","Burke County, North Carolina",36634,1496,32079,1761,23711,1844,1279,526,30800,1787,8368,1585,4555,1060
"492","37025","Cabarrus County, North Carolina",68798,1914,65128,2101,55959,2551,2431,786,62697,2153,9169,2234,3670,922
"493","37027","Caldwell County, North Carolina",32513,1464,28352,1773,21892,1567,2058,660,26294,1884,6460,1097,4161,1383
"494","37031","Carteret County, North Carolina",28962,1649,26616,1734,22563,1508,1144,389,25472,1730,4053,910,2346,755
"495","37035","Catawba County, North Carolina",62417,1772,56406,1916,43904,2299,2132,657,54274,1949,12502,2009,6011,1043
"496","37037","Chatham County, North Carolina",30674,947,28017,1432,23889,1851,1612,772,26405,1523,4128,1089,2657,1001
"497","37045","Cleveland County, North Carolina",30599,1728,26479,1845,19772,1779,2233,742,24246,1816,6707,1327,4120,885
"498","37049","Craven County, North Carolina",42221,1600,38780,1947,29590,2467,2028,663,36752,1879,9190,1934,3441,982
"499","37051","Cumberland County, North Carolina",128135,2243,117514,2559,94705,3237,3609,720,113905,2502,22809,1864,10621,1490
"500","37057","Davidson County, North Carolina",69938,1667,63552,2030,49150,2457,2543,902,61009,2049,14402,2203,6386,1200
"501","37063","Durham County, North Carolina",131140,2711,124893,2828,105715,3406,4550,1262,120343,3053,19178,3068,6247,1272
"502","37067","Forsyth County, North Carolina",148151,2664,139011,2612,112204,3248,5967,1147,133044,2831,26807,3059,9140,1274
"503","37069","Franklin County, North Carolina",26720,1244,23832,1383,18792,1715,1130,506,22702,1408,5040,1350,2888,828
"504","37071","Gaston County, North Carolina",85705,1578,79597,1885,62569,2159,3336,823,76261,1878,17028,1860,6108,972
"505","37081","Guilford County, North Carolina",206950,3305,188312,4024,159855,4620,6633,1277,181679,3991,28457,3145,18638,2483
"506","37085","Harnett County, North Carolina",46416,1461,43323,1552,36911,1656,926,332,42397,1511,6412,1123,3093,671
"507","37089","Henderson County, North Carolina",51115,1508,47731,1866,38771,2525,2138,709,45593,1921,8960,1650,3384,961
"508","37097","Iredell County, North Carolina",68145,1701,63909,1750,53960,2069,3154,833,60755,1770,9949,1577,4236,915
"509","37101","Johnston County, North Carolina",73567,1982,68699,2234,57743,2680,2567,1262,66132,2297,10956,1783,4868,1318
"510","37109","Lincoln County, North Carolina",34418,1246,31320,1178,26330,1670,1359,500,29961,1257,4990,1256,3098,709
"511","37119","Mecklenburg County, North Carolina",426313,4517,407120,4722,347924,5658,9662,1591,397458,5280,59196,4170,19193,2460
"512","37125","Moore County, North Carolina",41530,1339,37654,1752,32917,1886,1871,734,35783,1693,4737,1096,3876,1236
"513","37127","Nash County, North Carolina",37574,1750,33900,1830,23556,2339,1621,618,32279,1860,10344,2019,3674,824
"514","37129","New Hanover County, North Carolina",100189,2499,94870,2741,84209,2976,3313,911,91557,2770,10661,1781,5319,1308
"515","37133","Onslow County, North Carolina",63604,2606,61598,2701,53024,3255,1627,541,59971,2648,8574,1914,2006,688
"516","37135","Orange County, North Carolina",55259,1600,53763,1957,48230,2345,1591,587,52172,2042,5533,1497,1496,785
"517","37147","Pitt County, North Carolina",70926,2307,65849,2445,53000,2696,1934,641,63915,2573,12849,2107,5077,1267
"518","37151","Randolph County, North Carolina",56117,1793,50934,2205,38973,2443,2330,721,48604,2068,11961,1967,5183,1166
"519","37155","Robeson County, North Carolina",46272,863,38670,1130,26260,1420,1503,559,37167,1141,12410,1164,7602,897
"520","37157","Rockingham County, North Carolina",38462,1483,30504,1860,23899,1811,1731,645,28773,1896,6605,1463,7958,1368
"521","37159","Rowan County, North Carolina",55241,1463,50328,1515,40100,2066,1891,518,48437,1599,10228,1824,4913,1018
"522","37161","Rutherford County, North Carolina",27970,1392,25194,1463,18871,1867,1209,508,23985,1541,6323,1465,2776,719
"523","37171","Surry County, North Carolina",28408,1215,24854,1311,19282,1298,1500,525,23354,1341,5572,1171,3554,659
"524","37179","Union County, North Carolina",77954,1511,74651,1829,66106,2351,3283,1027,71368,2071,8545,1479,3303,776
"525","37183","Wake County, North Carolina",419361,3766,406426,4157,363271,5476,10158,1599,396268,4643,43155,4546,12935,2175
"526","37191","Wayne County, North Carolina",48482,1541,42745,1947,34311,1973,1285,593,41460,1991,8434,1584,5737,1303
"527","37193","Wilkes County, North Carolina",28376,1523,24036,1826,19397,1866,2172,724,21864,1814,4639,1072,4340,1090
"528","37195","Wilson County, North Carolina",32384,1354,25961,1462,20215,1755,1232,600,24729,1468,5746,1243,6423,1281
"529","38015","Burleigh County, North Dakota",38438,1461,35127,1664,30286,1745,1868,791,33259,1637,4841,1196,3311,1016
"530","38017","Cass County, North Dakota",78736,1627,74387,2204,62367,3139,2185,697,72202,2259,12020,2174,4349,1325
"531","38035","Grand Forks County, North Dakota",31506,911,29914,1055,25344,1538,909,495,29005,941,4570,1295,1592,625
"532","38101","Ward County, North Dakota",28908,1521,27917,1574,22538,1614,847,409,27070,1635,5379,1163,991,463
"533","39003","Allen County, Ohio",40460,1224,37596,1391,29360,1583,1800,442,35796,1430,8236,1307,2864,674
"534","39007","Ashtabula County, Ohio",39490,1420,34924,1531,25481,1712,1824,633,33100,1530,9443,1417,4566,984
"535","39009","Athens County, Ohio",22659,1283,21114,1268,17406,1488,915,447,20199,1300,3708,1050,1545,493
"536","39013","Belmont County, Ohio",25651,1482,21415,1381,16642,1309,1170,353,20245,1363,4773,994,4236,930
"537","39017","Butler County, Ohio",140141,2045,132026,2284,108695,2727,3776,792,128250,2509,23331,2653,8115,1278
"538","39023","Clark County, Ohio",54406,1390,49715,1550,40329,1763,3640,699,46075,1634,9386,1427,4691,860
"539","39025","Clermont County, Ohio",80041,1391,75193,1624,64196,2101,3468,902,71725,1719,10997,1654,4848,1042
"540","39029","Columbiana County, Ohio",40560,1529,35852,1763,28219,1515,2747,771,33105,1797,7633,1207,4708,1137
"541","39035","Cuyahoga County, Ohio",549471,4331,499629,4777,389438,5693,25188,2353,474441,4935,110191,5487,49842,3179
"542","39041","Delaware County, Ohio",73290,1137,71365,1253,66566,1688,2093,733,69272,1391,4799,1186,1925,626
"543","39043","Erie County, Ohio",30308,1638,27588,1916,23520,2017,1335,578,26253,1860,4068,968,2720,902
"544","39045","Fairfield County, Ohio",59031,1166,55244,1415,47740,2095,2722,741,52522,1581,7504,1784,3787,846
"545","39049","Franklin County, Ohio",522383,4463,495484,4994,418567,7043,16820,1966,478664,5191,76917,5402,26899,2977
"546","39055","Geauga County, Ohio",35439,730,30564,963,26633,1334,1106,470,29458,997,3931,1056,4875,829
"547","39057","Greene County, Ohio",66154,1441,62236,1765,53701,2229,3111,811,59125,1810,8535,1605,3918,981
"548","39061","Hamilton County, Ohio",347235,3728,322431,4961,268169,5334,14804,1619,307627,4972,54262,4485,24804,3011
"549","39063","Hancock County, Ohio",32490,1063,30164,1262,25963,1581,1915,590,28249,1382,4201,1017,2326,840
"550","39081","Jefferson County, Ohio",27515,1087,23664,1320,17775,1214,1323,461,22341,1374,5889,1082,3851,806
"551","39085","Lake County, Ohio",96967,1727,90279,2014,78214,2359,5486,967,84793,2009,12065,1927,6688,1373
"552","39089","Licking County, Ohio",66604,1282,62620,1574,54461,1810,2840,682,59780,1757,8159,1511,3984,897
"553","39093","Lorain County, Ohio",120299,2470,111904,2798,94985,2989,6367,1098,105537,2908,16919,2182,8395,1496
"554","39095","Lucas County, Ohio",182105,2681,166919,3254,126971,3952,6457,1238,160462,3299,39948,3494,15186,1957
"555","39099","Mahoning County, Ohio",100057,2085,90018,2385,72140,2965,5486,937,84532,2371,17878,2088,10039,1654
"556","39101","Marion County, Ohio",25013,1085,22877,1156,17042,1348,1194,494,21683,1253,5835,1128,2136,589
"557","39103","Medina County, Ohio",70450,1101,67180,1260,58597,1899,3456,938,63724,1592,8583,1672,3270,789
"558","39109","Miami County, Ohio",41273,1168,38200,1375,31483,1609,2348,792,35852,1474,6717,1201,3073,760
"559","39113","Montgomery County, Ohio",224831,2542,206830,2810,162579,3196,11141,1373,195689,3014,44251,3099,18001,2116
"560","39119","Muskingum County, Ohio",33342,1373,28838,1545,23186,1648,1756,620,27082,1496,5652,1048,4504,996
"561","39133","Portage County, Ohio",61018,1936,56428,2187,47925,2524,3756,1022,52672,2316,8503,1621,4590,1346
"562","39139","Richland County, Ohio",49812,1271,43997,1520,35674,1951,2166,579,41831,1575,8323,1298,5815,1116
"563","39141","Ross County, Ohio",28365,1372,25733,1319,19216,1569,1164,493,24569,1425,6517,1401,2632,682
"564","39145","Scioto County, Ohio",29319,1454,25165,1518,17755,1679,1275,528,23890,1597,7410,1541,4154,878
"565","39151","Stark County, Ohio",154280,2092,141928,2356,113085,2625,6623,1036,135305,2543,28843,2796,12352,1709
"566","39153","Summit County, Ohio",224629,3214,207820,3511,168763,4609,10564,1406,197256,3899,39057,3181,16809,1970
"567","39155","Trumbull County, Ohio",84159,2060,74048,2246,60416,2427,4983,837,69065,2332,13632,1742,10111,1460
"568","39157","Tuscarawas County, Ohio",36788,1156,32419,1405,26281,1465,1867,648,30552,1495,6138,1360,4369,921
"569","39165","Warren County, Ohio",84460,1882,81261,1913,72919,2076,2786,750,78475,1977,8342,1564,3199,802
"570","39169","Wayne County, Ohio",44589,806,37651,943,31238,1274,2007,544,35644,1035,6413,1175,6938,976
"571","39173","Wood County, Ohio",51353,1178,48741,1327,42010,1837,1930,652,46811,1349,6731,1287,2612,578
"572","40017","Canadian County, Oklahoma",46005,1005,43980,1238,38800,1577,1298,422,42682,1249,5180,1109,2025,878
"573","40027","Cleveland County, Oklahoma",108673,1881,103533,2005,87680,2890,2774,769,100759,2060,15853,2442,5140,1130
"574","40031","Comanche County, Oklahoma",41843,1796,39472,1917,30580,1810,1559,692,37913,1857,8892,1399,2371,690
"575","40037","Creek County, Oklahoma",26561,712,24403,802,17374,929,750,234,23653,834,7029,716,2158,430
"576","40101","Muskogee County, Oklahoma",26842,769,24158,904,17124,1090,526,243,23632,958,7034,821,2684,545
"577","40109","Oklahoma County, Oklahoma",305493,3296,285050,3376,216145,4624,8092,1210,276958,3433,68905,4065,20443,2190
"578","40119","Payne County, Oklahoma",31788,1484,30055,1659,25762,1801,926,474,29129,1764,4293,839,1733,749
"579","40125","Pottawatomie County, Oklahoma",25655,667,23230,839,17611,887,908,323,22322,863,5619,714,2425,465
"580","40131","Rogers County, Oklahoma",35531,891,33263,999,27082,1136,1372,368,31891,1021,6181,907,2268,533
"581","40143","Tulsa County, Oklahoma",255352,1952,240690,1929,189492,2833,7203,961,233487,1978,51198,2302,14662,1231
"582","40145","Wagoner County, Oklahoma",29837,611,27788,716,22273,882,961,340,26827,753,5515,770,2049,459
"583","41003","Benton County, Oregon",37378,988,36092,1071,33625,1229,1717,616,34375,1189,2467,755,1286,579
"584","41005","Clackamas County, Oregon",161295,2077,153356,2711,136201,3268,5932,1212,147424,2788,17155,2151,7939,1742
"585","41017","Deschutes County, Oregon",76528,2717,74305,2800,65607,3091,2217,708,72088,2873,8698,1648,2223,814
"586","41019","Douglas County, Oregon",46186,1473,43230,1813,35382,2294,3748,1026,39482,1809,7848,1696,2956,880
"587","41029","Jackson County, Oregon",87800,2140,82229,2195,70488,2490,4908,1426,77321,2338,11741,2058,5571,1324
"588","41033","Josephine County, Oregon",35206,1163,32531,1400,27910,1452,2350,789,30181,1610,4621,1227,2675,873
"589","41035","Klamath County, Oregon",29357,1030,27292,1183,21392,1499,1322,459,25970,1249,5900,1019,2065,592
"590","41039","Lane County, Oregon",155696,2263,146765,2568,127476,3246,6839,1247,139926,3013,19289,2717,8931,1355
"591","41043","Linn County, Oregon",49407,868,47020,1054,38646,1736,2396,593,44624,1305,8374,1620,2387,668
"592","41047","Marion County, Oregon",121061,2226,115532,2368,97549,2885,5983,1231,109549,2420,17983,2233,5529,1192
"593","41051","Multnomah County, Oregon",337903,3138,323247,3227,286534,4263,8347,1274,314900,3350,36713,3652,14656,2316
"594","41053","Polk County, Oregon",31224,920,29803,993,25355,1335,1411,532,28392,1052,4448,1261,1421,563
"595","41059","Umatilla County, Oregon",27538,1041,25572,1283,20395,1527,510,252,25062,1266,5177,1126,1966,701
"596","41067","Washington County, Oregon",222877,2644,216609,2836,200963,3298,6388,1179,210221,3024,15646,2329,6268,1511
"597","41071","Yamhill County, Oregon",36323,1266,34535,1373,30065,1693,1727,563,32808,1345,4470,1113,1788,679
"598","42001","Adams County, Pennsylvania",38703,1303,34722,1601,28711,1555,2145,477,32577,1580,6011,953,3981,868
"599","42003","Allegheny County, Pennsylvania",553858,4070,507872,4951,429969,5449,24009,2105,483863,4648,77903,4056,45986,3225
"600","42005","Armstrong County, Pennsylvania",29095,869,24582,956,20076,1175,1756,326,22826,988,4506,704,4513,745
"601","42007","Beaver County, Pennsylvania",70745,1646,62936,1803,52817,1813,3124,679,59812,1728,10119,1318,7809,1315
"602","42011","Berks County, Pennsylvania",154696,2552,138963,2691,114947,3164,8316,1154,130647,2853,24016,2377,15733,1813
"603","42013","Blair County, Pennsylvania",52497,1379,47126,1543,36991,1801,3313,689,43813,1572,10135,1480,5371,881
"604","42017","Bucks County, Pennsylvania",240491,2073,228016,2400,205723,3482,9540,1375,218476,2422,22293,2495,12475,1628
"605","42019","Butler County, Pennsylvania",77920,1627,70788,2130,61542,2057,4025,866,66763,2249,9246,1399,7132,1419
"606","42021","Cambria County, Pennsylvania",56490,1468,48675,1745,38697,1851,3527,596,45148,1739,9978,1283,7815,948
"607","42025","Carbon County, Pennsylvania",27107,1430,24236,1583,19132,1561,1848,599,22388,1707,5104,1385,2871,659
"608","42027","Centre County, Pennsylvania",58963,2042,53680,2166,49167,2254,3232,1149,50448,2424,4513,976,5283,946
"609","42029","Chester County, Pennsylvania",193234,2161,183712,2487,167141,3322,6462,1283,177250,2597,16571,2290,9522,1441
"610","42033","Clearfield County, Pennsylvania",31990,1085,26858,1216,21433,1190,2187,467,24671,1302,5425,866,5132,844
"611","42037","Columbia County, Pennsylvania",26219,1002,23245,1008,18729,1254,1907,632,21338,1228,4516,998,2974,508
"612","42039","Crawford County, Pennsylvania",35387,1116,31136,1253,24837,1558,2660,512,28476,1304,6299,1123,4251,661
"613","42041","Cumberland County, Pennsylvania",101823,1756,92421,1916,83981,2304,4238,1121,88183,2083,8440,1594,9402,1354
"614","42043","Dauphin County, Pennsylvania",113905,2480,102809,2747,83610,3048,4793,1047,98016,3071,19199,2419,11096,1581
"615","42045","Delaware County, Pennsylvania",209502,2047,196668,2724,168226,3526,7864,1310,188804,2916,28442,2733,12834,2123
"616","42049","Erie County, Pennsylvania",110128,1696,99411,2267,79483,2405,4912,1073,94499,2209,19928,1932,10717,1611
"617","42051","Fayette County, Pennsylvania",54955,1449,46500,1739,35905,2037,2633,677,43867,1794,10595,1547,8455,1198
"618","42055","Franklin County, Pennsylvania",60260,1627,55263,1974,47520,2077,4243,1184,51020,2208,7743,1489,4997,1142
"619","42063","Indiana County, Pennsylvania",30704,1696,26083,1558,19101,1324,1855,481,24228,1605,6982,997,4621,797
"620","42069","Lackawanna County, Pennsylvania",88154,1936,80077,2269,64744,2607,4346,794,75731,2444,15333,2068,8077,1138
"621","42071","Lancaster County, Pennsylvania",204701,1948,182005,3185,157972,3578,8136,1337,173869,3311,24033,2234,22696,2318
"622","42073","Lawrence County, Pennsylvania",37282,916,32788,1145,24786,1319,1435,505,31353,1156,8002,1228,4494,866
"623","42075","Lebanon County, Pennsylvania",53861,1156,48775,1491,40645,1958,3497,822,45278,1492,8130,1531,5086,992
"624","42077","Lehigh County, Pennsylvania",137847,2572,126336,2863,105944,3157,5803,951,120533,3129,20392,2573,11511,1843
"625","42079","Luzerne County, Pennsylvania",130890,2754,117163,2750,90767,3130,6661,1134,110502,2857,26396,2513,13727,1283
"626","42081","Lycoming County, Pennsylvania",44842,1617,39953,1831,32433,2094,2724,605,37229,1883,7520,1293,4889,789
"627","42085","Mercer County, Pennsylvania",46427,1338,40551,1715,31872,1575,2639,659,37912,1763,8679,1289,5876,1106
"628","42089","Monroe County, Pennsylvania",56274,3491,52892,3325,46676,2998,2498,789,50394,3394,6216,1339,3382,1316
"629","42091","Montgomery County, Pennsylvania",321373,2596,307298,3157,280382,3706,14297,1847,293001,3586,26916,2905,14075,1699
"630","42095","Northampton County, Pennsylvania",114950,1810,103741,2408,88246,2317,4588,983,99153,2377,15495,2228,11209,1681
"631","42097","Northumberland County, Pennsylvania",38592,1525,31921,1513,24087,1469,2182,570,29739,1621,7834,1219,6671,1034
"632","42101","Philadelphia County, Pennsylvania",619505,4709,562041,5876,440341,7025,20443,2383,541598,6402,121700,5260,57464,4304
"633","42107","Schuylkill County, Pennsylvania",58242,1840,50688,2024,39552,2284,3042,640,47646,1974,11136,1619,7554,1078
"634","42111","Somerset County, Pennsylvania",29456,1072,24436,1230,20120,1310,1782,493,22654,1277,4316,730,5020,759
"635","42125","Washington County, Pennsylvania",86716,1702,78139,1900,63019,2483,4483,726,73656,2006,15120,1735,8577,1257
"636","42129","Westmoreland County, Pennsylvania",155147,1991,138038,2327,116481,3015,7365,1275,130673,2619,21557,2357,17109,1705
"637","42133","York County, Pennsylvania",175441,2373,161730,2790,137349,3450,8058,1368,153672,2597,24381,2435,13711,1722
"638","44003","Kent County, Rhode Island",70166,1470,64767,1976,56996,2278,3526,890,61241,2054,7771,1552,5399,1359
"639","44005","Newport County, Rhode Island",33690,1958,31842,1955,27485,1780,2184,677,29658,1948,4357,1091,1848,559
"640","44007","Providence County, Rhode Island",237518,3103,216711,3656,173710,4794,11288,1700,205423,3811,43001,4160,20807,2491
"641","44009","Washington County, Rhode Island",48051,2104,45598,2165,41687,2212,2469,685,43129,2190,3911,1101,2453,760
"642","45003","Aiken County, South Carolina",67889,2252,62581,2386,50283,2580,2350,666,60231,2500,12298,1940,5308,1261
"643","45007","Anderson County, South Carolina",75825,2343,69192,2503,55037,2624,3722,868,65470,2475,14155,2071,6633,1323
"644","45013","Beaufort County, South Carolina",73043,2340,69903,2562,58999,2610,2491,841,67412,2857,10904,1823,3140,902
"645","45015","Berkeley County, South Carolina",80640,1907,75805,1995,63751,2365,2966,1027,72839,2197,12054,1662,4835,1177
"646","45019","Charleston County, South Carolina",165568,3515,157652,3827,131750,4655,4252,1152,153400,3942,25902,3012,7916,1596
"647","45031","Darlington County, South Carolina",24801,1419,21270,1438,14735,1589,1068,447,20202,1536,6535,1352,3531,892
"648","45035","Dorchester County, South Carolina",57768,1427,54264,1713,46818,2173,1900,891,52364,1754,7446,1437,3504,979
"649","45041","Florence County, South Carolina",53047,1606,47857,1796,35286,1917,828,368,47029,1736,12571,1786,5190,1132
"650","45045","Greenville County, South Carolina",199551,2904,186190,3338,155927,3990,6241,1174,179949,3457,30263,2783,13361,1711
"651","45047","Greenwood County, South Carolina",28544,1097,24919,1333,18324,1603,1055,508,23864,1327,6595,1267,3625,855
"652","45051","Horry County, South Carolina",140260,3637,132322,3802,104978,3729,4882,1099,127440,3737,27344,2709,7938,1385
"653","45055","Kershaw County, South Carolina",24544,1349,22634,1377,19749,1343,760,395,21874,1431,2885,733,1910,736
"654","45057","Lancaster County, South Carolina",35410,1658,32485,1804,26186,2012,1185,658,31300,1928,6299,1260,2925,933
"655","45059","Laurens County, South Carolina",25901,1333,22749,1795,16334,1863,1365,515,21384,1785,6415,1301,3152,1137
"656","45063","Lexington County, South Carolina",118193,2184,110098,2455,89463,3150,3344,627,106754,2533,20635,2358,8095,1554
"657","45073","Oconee County, South Carolina",31530,1806,28753,1689,21976,1528,1893,657,26860,1766,6777,1340,2777,782
"658","45075","Orangeburg County, South Carolina",32129,1945,27751,2031,19872,1928,891,473,26860,2068,7879,1412,4378,1031
"659","45077","Pickens County, South Carolina",48203,1687,43763,1902,34987,2033,1289,433,42474,1929,8776,1286,4440,1043
"660","45079","Richland County, South Carolina",153484,3941,146343,4438,117520,4677,3958,1050,142385,4351,28823,3441,7141,1608
"661","45083","Spartanburg County, South Carolina",121256,2317,109927,2380,86128,3027,4010,1105,105917,2486,23799,2440,11329,1557
"662","45085","Sumter County, South Carolina",44105,1260,39760,1532,31434,2112,1877,653,37883,1697,8326,1692,4345,939
"663","45091","York County, South Carolina",108400,1474,104055,1772,83400,2941,1871,509,102184,1859,20655,2379,4345,1102
"664","46099","Minnehaha County, South Dakota",81046,1478,76140,1846,64261,2379,2004,612,74136,1815,11879,1791,4906,1010
"665","46103","Pennington County, South Dakota",44676,1686,42219,1881,34424,2193,1896,607,40323,2022,7795,1684,2457,861
"666","47001","Anderson County, Tennessee",30175,1340,27647,1542,22576,1673,1093,396,26554,1623,5071,1015,2528,895
"667","47009","Blount County, Tennessee",50813,1557,45862,1835,36503,1796,2188,682,43674,1888,9359,1598,4951,1124
"668","47011","Bradley County, Tennessee",39992,1363,36256,1565,28746,1650,1982,700,34274,1634,7510,1343,3736,1196
"669","47037","Davidson County, Tennessee",289427,4247,276245,4532,229663,6289,8652,1478,267593,4430,46582,4445,13182,1645
"670","47059","Greene County, Tennessee",28323,1448,24342,1613,16233,1643,1277,418,23065,1545,8109,1701,3981,818
"671","47065","Hamilton County, Tennessee",148157,2642,135607,3103,110093,3981,3796,857,131811,3116,25514,3126,12550,1835
"672","47093","Knox County, Tennessee",191925,3205,180570,3575,146600,4209,5970,1203,174600,3885,33970,2666,11355,1595
"673","47113","Madison County, Tennessee",38930,1354,34639,1499,24660,1885,1322,576,33317,1567,9979,1293,4291,878
"674","47119","Maury County, Tennessee",37104,994,35186,1239,29421,1675,1405,553,33781,1438,5765,1287,1918,785
"675","47125","Montgomery County, Tennessee",76974,1909,74141,2080,63136,2530,2220,825,71921,2187,11005,1843,2833,976
"676","47141","Putnam County, Tennessee",31778,1119,27683,1329,24220,1640,1354,602,26329,1450,3463,1184,4095,915
"677","47147","Robertson County, Tennessee",26577,902,24981,1023,19132,1431,419,211,24562,1012,5849,1309,1596,616
"678","47149","Rutherford County, Tennessee",113797,2636,109310,3021,92767,3651,2570,787,106740,3047,16543,2653,4487,1232
"679","47155","Sevier County, Tennessee",37933,2403,34133,2539,26836,2194,1975,617,32158,2625,7297,1510,3800,1242
"680","47157","Shelby County, Tennessee",353950,4012,311942,5521,237973,6213,9427,1696,302515,5497,73969,5543,42008,3769
"681","47163","Sullivan County, Tennessee",68560,1882,61308,2006,48332,2455,3894,995,57414,2013,12976,1967,7252,1018
"682","47165","Sumner County, Tennessee",70098,1651,65511,2008,54310,2404,2050,594,63461,2038,11201,2097,4587,1120
"683","47179","Washington County, Tennessee",55817,1712,50040,2405,41624,2812,1611,621,48429,2521,8416,1875,5777,1277
"684","47187","Williamson County, Tennessee",84393,1193,81508,1475,77153,1763,2051,734,79457,1644,4355,1057,2885,844
"685","47189","Wilson County, Tennessee",51618,1815,48964,2053,42722,2123,1607,638,47357,2131,6242,1428,2654,933
"686","48005","Angelina County, Texas",32293,1229,29399,1126,21786,1431,1473,453,27926,1172,7613,1249,2894,788
"687","48021","Bastrop County, Texas",26393,1525,23967,1602,18401,1871,1398,644,22569,1580,5566,1828,2426,841
"688","48027","Bell County, Texas",126772,2430,118652,3189,103174,3675,4927,1329,113725,3336,15478,2143,8120,1816
"689","48029","Bexar County, Texas",646352,4813,608736,5869,477750,7186,15347,1932,593389,6054,130986,7379,37616,3160
"690","48037","Bowie County, Texas",34935,1517,29221,1582,21687,1530,1037,489,28184,1614,7534,1306,5714,1356
"691","48039","Brazoria County, Texas",129261,2246,125655,2640,106650,3566,2576,964,123079,2670,19005,2608,3606,1067
"692","48041","Brazos County, Texas",79971,2792,75893,2837,64192,2969,1901,966,73992,2905,11701,2392,4078,1260
"693","48061","Cameron County, Texas",129307,2801,109789,3130,70470,3846,2755,1295,107034,3583,39319,3674,19518,2123
"694","48085","Collin County, Texas",363599,3928,357624,4110,324903,5264,4233,1025,353391,4176,32721,3797,5975,1368
"695","48091","Comal County, Texas",57004,1375,54796,1462,50485,1944,2250,830,52546,1621,4311,1568,2208,682
"696","48099","Coryell County, Texas",22093,1237,20239,1263,17153,1399,1015,458,19224,1218,3086,989,1854,712
"697","48113","Dallas County, Texas",940587,5547,874102,7042,700079,8654,20519,2294,853583,7533,174023,7481,66485,4479
"698","48121","Denton County, Texas",305164,3815,300542,4199,274157,4979,4743,1140,295799,4187,26385,3463,4622,1229
"699","48135","Ector County, Texas",53155,1332,49050,1811,32241,2417,537,304,48513,1788,16809,2194,4105,1415
"700","48139","Ellis County, Texas",61465,1556,58660,1926,48308,2469,2181,769,56479,2144,10352,1635,2805,918
"701","48141","El Paso County, Texas",269150,3541,245777,3896,179392,4746,5547,1014,240230,4055,66385,4209,23373,2200
"702","48157","Fort Bend County, Texas",253030,3135,244291,3570,227572,4665,5054,1490,239237,3871,16719,3182,8739,2122
"703","48167","Galveston County, Texas",127092,2880,120866,3305,100897,3665,4675,1184,116191,3398,19969,2244,6226,1553
"704","48181","Grayson County, Texas",49024,1794,44234,2001,32372,2083,2289,704,41945,1954,11862,1870,4790,1150
"705","48183","Gregg County, Texas",45711,1858,42292,1954,31269,2316,1301,509,40991,1995,11023,1902,3419,906
"706","48187","Guadalupe County, Texas",56051,1420,53843,1513,44612,2037,1890,785,51953,1588,9231,1804,2208,726
"707","48201","Harris County, Texas",1647384,10077,1546971,12421,1257084,14192,37378,3629,1509593,12233,289887,10402,100413,6775
"708","48203","Harrison County, Texas",24197,1193,21717,1284,15565,1558,306,174,21411,1282,6152,1358,2480,1048
"709","48209","Hays County, Texas",77749,2243,75492,2320,67371,2717,1030,456,74462,2423,8121,1803,2257,1114
"710","48213","Henderson County, Texas",30607,1358,26662,1713,19641,1882,1056,454,25606,1646,7021,1408,3945,1001
"711","48215","Hidalgo County, Texas",247544,3892,221336,4712,144633,5294,4545,1635,216791,4801,76703,4754,26208,3055
"712","48231","Hunt County, Texas",35093,1197,32178,1424,23653,1509,925,460,31253,1387,8525,1484,2915,959
"713","48245","Jefferson County, Texas",89273,2715,84118,2740,55422,3216,2153,631,81965,2916,28696,2607,5155,1015
"714","48251","Johnson County, Texas",59113,1594,55244,1853,44094,2299,1480,552,53764,1913,11150,1798,3869,1203
"715","48257","Kaufman County, Texas",39835,1204,38443,1364,32047,1654,790,469,37653,1380,6396,1359,1392,486
"716","48291","Liberty County, Texas",27367,1657,24377,1785,16343,1507,783,421,23594,1857,8034,1514,2990,884
"717","48303","Lubbock County, Texas",117494,2362,110996,2589,88192,3400,2553,729,108443,2707,22804,2844,6498,1218
"718","48309","McLennan County, Texas",93021,1894,86245,2188,67533,2545,2751,774,83494,2309,18712,2305,6776,1325
"719","48329","Midland County, Texas",59325,1205,57126,1443,43400,2892,1382,981,55744,1642,13726,2781,2199,1021
"720","48339","Montgomery County, Texas",209528,3925,202953,4503,175130,4658,3390,1045,199563,4677,27823,3867,6575,1844
"721","48347","Nacogdoches County, Texas",24722,1323,22884,1397,15989,1959,1139,544,21745,1466,6895,1566,1838,586
"722","48355","Nueces County, Texas",131194,3135,120227,3564,89420,3251,3605,1106,116622,3597,30807,3181,10967,1727
"723","48361","Orange County, Texas",31913,1388,29278,1383,22170,1675,1077,450,28201,1490,7108,1399,2635,696
"724","48367","Parker County, Texas",43520,1693,41703,1639,35441,1870,1064,524,40639,1684,6262,1304,1817,760
"725","48375","Potter County, Texas",44180,1624,41166,1827,27379,1841,730,344,40436,1823,13787,1686,3014,941
"726","48381","Randall County, Texas",50261,1349,48097,1504,39999,1911,1572,627,46525,1476,8098,1329,2164,625
"727","48397","Rockwall County, Texas",36665,604,36417,655,33900,1048,283,278,36134,693,2517,902,248,218
"728","48409","San Patricio County, Texas",21872,1351,19909,1297,15195,1559,736,416,19173,1326,4714,1112,1963,714
"729","48423","Smith County, Texas",78600,2407,74309,2790,46429,3341,2153,787,72156,2727,27880,3296,4291,1303
"730","48439","Tarrant County, Texas",727094,5181,698468,5816,585993,8565,16956,2315,681512,5465,112475,5986,28626,3091
"731","48441","Taylor County, Texas",50282,1592,46318,1777,36634,1989,1760,679,44558,1876,9684,1642,3964,948
"732","48451","Tom Green County, Texas",43604,1687,40604,1782,32526,2106,1505,553,39099,1752,8078,1653,3000,906
"733","48453","Travis County, Texas",507751,5452,484180,6074,435871,6393,11586,2528,472594,5923,48309,4558,23571,3147
"734","48469","Victoria County, Texas",30058,1589,27368,1505,20043,1869,1276,608,26092,1533,7325,1381,2690,824
"735","48471","Walker County, Texas",22201,1485,19684,1528,15470,1494,559,353,19125,1546,4214,1488,2517,757
"736","48479","Webb County, Texas",76326,2150,70946,2207,47729,2739,1748,703,69198,2430,23217,2618,5380,1087
"737","48485","Wichita County, Texas",48315,2499,42242,2410,33405,2624,1283,450,40959,2394,8837,1767,6073,1392
"738","48491","Williamson County, Texas",193008,2970,188630,3090,172625,4179,4308,1145,184322,3103,16005,2990,4378,1012
"739","48497","Wise County, Texas",22882,1087,21255,1328,16327,1444,1019,501,20236,1384,4928,1194,1627,765
"740","49005","Cache County, Utah",40206,1109,39382,1235,36335,1455,1162,475,38220,1287,3047,856,824,513
"741","49011","Davis County, Utah",109358,1333,106828,1419,97974,2007,2119,686,104709,1509,8854,1657,2530,678
"742","49035","Salt Lake County, Utah",384692,3966,372203,4592,334697,4587,9818,1445,362385,4683,37506,3321,12489,2001
"743","49045","Tooele County, Utah",21292,786,20925,796,16686,1393,626,387,20299,899,4239,1347,367,267
"744","49049","Utah County, Utah",178152,1695,175551,1703,163529,2300,2227,488,173324,1812,12022,1778,2601,633
"745","49053","Washington County, Utah",63144,2292,60632,2498,53105,2695,2629,1079,58003,2661,7527,1878,2512,910
"746","49057","Weber County, Utah",87863,1481,84866,1594,74789,1880,2507,738,82359,1849,10077,1779,2997,805
"747","50007","Chittenden County, Vermont",68516,975,65233,1356,59339,1548,2511,771,62722,1518,5894,1187,3283,1133
"748","51003","Albemarle County, Virginia",43754,1134,40025,1685,36697,1833,1476,602,38549,1746,3328,1044,3729,1195
"749","51013","Arlington County, Virginia",111887,1847,107630,2362,102631,2464,2463,882,105167,2477,4999,1176,4257,1401
"750","51015","Augusta County, Virginia",29951,1333,27446,1524,21553,1760,1593,688,25853,1539,5893,1375,2505,776
"751","51019","Bedford County, Virginia",31390,1264,27730,1641,22840,1670,852,341,26878,1565,4890,1124,3660,895
"752","51041","Chesterfield County, Virginia",128920,1764,122624,2141,107938,2920,4991,930,117633,2323,14686,2428,6296,1196
"753","51059","Fairfax County, Virginia",400186,2978,391570,3422,370063,4285,12157,1606,379413,3611,21507,2799,8616,1796
"754","51061","Fauquier County, Virginia",24270,1052,22328,1207,19665,1271,482,220,21846,1224,2663,856,1942,585
"755","51069","Frederick County, Virginia",32010,1398,29550,1595,25384,1695,930,441,28620,1669,4166,936,2460,862
"756","51085","Hanover County, Virginia",39521,1078,36585,1387,32152,1790,933,292,35652,1430,4433,1200,2936,898
"757","51087","Henrico County, Virginia",130591,1988,120898,2574,103811,3608,4492,864,116406,2624,17087,2915,9693,1800
"758","51095","James City County, Virginia",30262,1513,28878,1607,25976,1640,732,450,28146,1618,2902,919,1384,730
"759","51107","Loudoun County, Virginia",133750,1935,131399,2120,124223,2114,2158,726,129241,2084,7176,1528,2351,696
"760","51121","Montgomery County, Virginia",36244,1423,34572,1514,29641,2012,1242,560,33330,1542,4931,1434,1672,598
"761","51153","Prince William County, Virginia",143508,1907,140840,2171,127304,2628,3244,826,137596,2197,13536,2050,2668,888
"762","51161","Roanoke County, Virginia",37506,1472,34375,1544,30268,1777,1334,449,33041,1564,4107,1176,3131,1001
"763","51165","Rockingham County, Virginia",30462,1157,27390,1380,22567,1710,1831,694,25559,1399,4823,1174,3072,760
"764","51177","Spotsylvania County, Virginia",46427,1134,44255,1271,38757,1462,1663,555,42592,1298,5498,1039,2172,628
"765","51179","Stafford County, Virginia",48092,1304,46787,1398,42401,1710,629,291,46158,1437,4386,1208,1305,567
"766","51199","York County, Virginia",26008,921,24842,1032,22008,1364,1190,636,23652,1035,2834,935,1166,572
"767","51510","Alexandria city, Virginia",71005,1523,68106,1887,62306,2270,1614,553,66492,1796,5800,1324,2899,898
"768","51550","Chesapeake city, Virginia",86878,1764,84048,1892,71065,2075,2173,680,81875,2004,12983,2070,2830,788
"769","51650","Hampton city, Virginia",55633,1442,52008,1663,43257,1980,2232,752,49776,1841,8751,1656,3625,1046
"770","51680","Lynchburg city, Virginia",28950,1238,27940,1283,23022,1503,810,364,27130,1327,4918,1041,1010,417
"771","51700","Newport News city, Virginia",70918,2279,66443,2323,53482,2601,2095,638,64348,2457,12961,1869,4475,1062
"772","51710","Norfolk city, Virginia",88387,2248,81678,2584,64340,2730,2801,978,78877,2651,17338,2042,6709,1063
"773","51740","Portsmouth city, Virginia",36089,1133,33571,1227,26175,1577,2051,552,31520,1192,7396,1446,2518,601
"774","51760","Richmond city, Virginia",89878,2207,81418,2656,65273,2741,2197,678,79221,2660,16145,2144,8460,1772
"775","51770","Roanoke city, Virginia",40810,1405,35580,1779,25453,1970,1115,447,34465,1809,10127,1666,5230,1339
"776","51800","Suffolk city, Virginia",34597,1038,32162,1204,28025,1449,612,303,31550,1239,4137,1192,2435,799
"777","51810","Virginia Beach city, Virginia",175029,2072,169091,2530,147694,3113,4929,963,164162,2669,21397,2326,5938,1527
"778","53005","Benton County, Washington",73678,1554,70184,1779,59491,2334,2204,796,67980,1774,10693,1903,3494,1140
"779","53007","Chelan County, Washington",28974,1437,26271,1782,22141,1926,1396,489,24875,1830,4130,1129,2703,1112
"780","53009","Clallam County, Washington",33022,1395,30803,1487,26229,1609,2273,688,28530,1619,4574,1124,2219,692
"781","53011","Clark County, Washington",180862,1845,173397,2239,156027,2858,7214,1288,166183,2490,17370,2140,7465,1501
"782","53015","Cowlitz County, Washington",42790,1091,40098,1456,33083,1929,2663,761,37435,1652,7015,1542,2692,893
"783","53021","Franklin County, Washington",28162,801,26779,1106,21331,1577,751,474,26028,1223,5448,1264,1383,708
"784","53025","Grant County, Washington",30866,1944,28291,2047,21910,1968,1044,493,27247,2047,6381,1356,2575,756
"785","53027","Grays Harbor County, Washington",29920,1485,27847,1497,23690,1537,2378,686,25469,1450,4157,1015,2073,737
"786","53029","Island County, Washington",35586,1400,34551,1465,31514,1622,1343,593,33208,1489,3037,977,1035,551
"787","53033","King County, Washington",907761,5540,880262,6520,804755,7563,26370,2688,853892,7325,75507,4774,27499,3173
"788","53035","Kitsap County, Washington",107525,1905,104283,2090,95301,2590,3943,930,100340,2332,8982,1658,3242,797
"789","53041","Lewis County, Washington",31879,1111,29468,1143,24313,1384,1940,637,27528,1160,5155,884,2411,696
"790","53045","Mason County, Washington",24820,1724,23010,1661,20230,1688,838,531,22172,1733,2780,689,1810,688
"791","53053","Pierce County, Washington",333657,3333,320652,3590,276993,5208,12129,1714,308523,4105,43659,4265,13005,1832
"792","53057","Skagit County, Washington",49043,1429,45701,1740,41238,1871,2355,629,43346,1763,4463,932,3342,869
"793","53061","Snohomish County, Washington",299827,3248,289173,3666,259929,4205,9887,1529,279286,3852,29244,3158,10654,1961
"794","53063","Spokane County, Washington",211723,2427,199411,3046,173253,3589,7130,1177,192281,3123,26158,2662,12312,1679
"795","53067","Thurston County, Washington",112909,1988,108022,2026,98680,2548,5800,1272,102222,2306,9342,1875,4887,1230
"796","53073","Whatcom County, Washington",88794,2439,84868,2650,75197,2934,3611,994,81257,3130,9671,2092,3926,1175
"797","53077","Yakima County, Washington",83992,1666,77147,2107,56696,2334,2865,643,74282,2100,20451,2416,6845,1415
"798","54003","Berkeley County, West Virginia",46395,1509,44375,1627,35298,1958,1637,628,42738,1714,9077,1584,2020,612
"799","54011","Cabell County, West Virginia",38040,1440,33538,1755,25895,1716,1551,626,31987,1816,7643,1435,4502,1161
"800","54033","Harrison County, West Virginia",25905,1348,23695,1382,18844,1410,592,305,23103,1335,4851,945,2210,639
"801","54039","Kanawha County, West Virginia",78384,2302,69071,2690,51100,2884,3426,925,65645,2591,17971,1954,9313,1636
"802","54061","Monongalia County, West Virginia",40401,1394,38551,1552,33099,1920,1769,663,36782,1686,5452,1288,1850,666
"803","54081","Raleigh County, West Virginia",31331,1288,27801,1402,20823,1668,1758,647,26043,1520,6978,1466,3530,1022
"804","54107","Wood County, West Virginia",34182,1286,30803,1622,23237,1624,2522,888,28281,1611,7566,1323,3379,1034
"805","55009","Brown County, Wisconsin",107385,1227,99061,1818,83174,2443,4336,1065,94725,2150,15887,1898,8324,1231
"806","55025","Dane County, Wisconsin",229760,1902,220895,2513,201213,3404,7387,1154,213508,2846,19682,2276,8865,1512
"807","55027","Dodge County, Wisconsin",35104,947,32165,981,25636,1100,1830,476,30335,1075,6529,963,2939,581
"808","55035","Eau Claire County, Wisconsin",41385,1260,38880,1400,32697,2023,2842,796,36038,1508,6183,1524,2505,574
"809","55039","Fond du Lac County, Wisconsin",42604,1050,37916,1370,31228,1577,1789,611,36127,1488,6688,1063,4688,805
"810","55055","Jefferson County, Wisconsin",32783,1218,30249,1344,25531,1407,2477,697,27772,1312,4718,915,2534,717
"811","55059","Kenosha County, Wisconsin",64187,1921,60679,1843,51567,2054,2392,708,58287,1921,9112,1405,3508,982
"812","55063","La Crosse County, Wisconsin",48175,1115,44784,1437,38295,1540,1688,649,43096,1627,6489,1025,3391,922
"813","55071","Manitowoc County, Wisconsin",33831,769,29881,1042,24555,1319,1374,402,28507,1014,5326,1135,3950,849
"814","55073","Marathon County, Wisconsin",54765,1202,49743,1459,41828,1695,2818,641,46925,1623,7915,1161,5022,887
"815","55079","Milwaukee County, Wisconsin",383665,3473,344516,3973,270252,5637,14533,1571,329983,4229,74264,4659,39149,2986
"816","55087","Outagamie County, Wisconsin",74974,1091,70175,1382,60829,1707,3385,784,66790,1685,9346,1394,4799,821
"817","55089","Ozaukee County, Wisconsin",35795,961,33873,1007,31494,1044,1897,641,31976,1212,2379,627,1922,495
"818","55097","Portage County, Wisconsin",29063,733,26562,1002,23542,1240,1573,502,24989,1048,3020,879,2501,599
"819","55101","Racine County, Wisconsin",78905,1384,72597,2108,60025,2200,3428,732,69169,2107,12572,1816,6308,1480
"820","55105","Rock County, Wisconsin",65316,1200,60264,1490,48809,1921,2543,627,57721,1552,11455,1500,5052,926
"821","55109","St. Croix County, Wisconsin",34731,1011,33500,1052,26827,1586,1052,333,32448,1099,6673,1613,1231,435
"822","55117","Sheboygan County, Wisconsin",48691,930,43993,1391,37018,1748,2613,604,41380,1544,6975,1141,4698,1013
"823","55127","Walworth County, Wisconsin",42799,1177,39285,1367,34847,1804,1504,545,37781,1475,4438,1034,3514,798
"824","55131","Washington County, Wisconsin",55256,992,51496,1364,44318,1582,2621,625,48875,1375,7178,1259,3760,842
"825","55133","Waukesha County, Wisconsin",160635,1655,152893,2119,139475,2756,7903,1182,144990,2305,13418,1729,7742,1254
"826","55139","Winnebago County, Wisconsin",71238,1399,64924,1658,54104,1899,3344,720,61580,1703,10820,1475,6314,848
"827","55141","Wood County, Wisconsin",32684,1008,29724,1200,23704,1405,2051,514,27673,1233,6020,1038,2960,666
"828","56021","Laramie County, Wyoming",41739,990,39221,1198,32994,1635,1927,593,37294,1321,6227,1370,2518,706
"829","56025","Natrona County, Wyoming",33044,1230,31121,1343,26747,1628,1641,506,29480,1492,4374,1153,1923,705
"830","72013","Arecibo Municipio, Puerto Rico",32090,1274,25210,1483,12810,1390,397,282,24813,1493,12400,1299,6880,1134
"831","72021","Bayamón Municipio, Puerto Rico",68980,2149,60745,2342,32957,2213,1739,463,59006,2317,27788,1947,8235,1095
"832","72025","Caguas Municipio, Puerto Rico",47669,1858,38722,2027,22749,2087,904,420,37818,2071,15973,1924,8947,1252
"833","72031","Carolina Municipio, Puerto Rico",58602,2461,51586,2545,30306,2348,1590,556,49996,2580,21280,2451,7016,1331
"834","72061","Guaynabo Municipio, Puerto Rico",33125,1455,28959,1490,20711,1422,851,382,28108,1479,8248,1425,4166,906
"835","72097","Mayagüez Municipio, Puerto Rico",28649,1616,22630,1796,13483,1411,1283,512,21347,1771,9147,1548,6019,1092
"836","72113","Ponce Municipio, Puerto Rico",52837,1952,39089,1783,23544,1441,2463,624,36626,1844,15545,1632,13748,1528
"837","72127","San Juan Municipio, Puerto Rico",138800,3232,99515,3795,61968,3307,3827,1027,95688,3690,37547,2782,39285,3039
"838","72135","Toa Alta Municipio, Puerto Rico",22650,1148,20927,1267,10821,1292,264,275,20663,1296,10106,1431,1723,606
"839","72137","Toa Baja Municipio, Puerto Rico",28291,1322,24001,1425,12967,1441,359,173,23642,1416,11034,1348,4290,879
"840","72139","Trujillo Alto Municipio, Puerto Rico",23263,1267,19205,1320,12146,1322,570,313,18635,1307,7059,1165,4058,915
